//No idea what this does, but it seemed important
"a" = (
/obj/machinery/vending/access/command,
/turf/template_noop,
/area/template_noop)

(1,1,1) = {"
a
"}