//MAP CONVERTED BY dmm2tgm.py THIS HEADER COMMENT PREVENTS RECONVERSION, DO NOT REMOVE
"a" = (
/turf/closed/wall/r_wall,
/area/station/command/heads_quarters/nt_rep)
"b" = (
/obj/structure/closet/secure_closet/nanotrasen_consultant,
/turf/open/floor/iron/dark/textured_large,
/area/station/command/heads_quarters/nt_rep)
"c" = (
/obj/machinery/door/airlock/corporate{
	name = "NT Consultant's Office"
	},
/obj/structure/cable,
/obj/machinery/atmospherics/pipe/smart/manifold4w/scrubbers/hidden/layer2,
/obj/machinery/door/firedoor,
/obj/effect/mapping_helpers/airlock/access/all/cent_com/rep_door,
/obj/structure/disposalpipe/junction/flip{
	dir = 8
	},
/obj/effect/landmark/navigate_destination/autoname,
/obj/effect/mapping_helpers/airlock/unres{
	dir = 8
	},
/obj/machinery/atmospherics/pipe/smart/manifold4w/supply/hidden/layer4,
/turf/open/floor/iron/dark/textured_large,
/area/station/command/heads_quarters/nt_rep)
"g" = (
/obj/machinery/atmospherics/pipe/smart/manifold4w/scrubbers/hidden/layer2,
/obj/structure/disposalpipe/segment{
	dir = 4
	},
/turf/open/floor/iron/dark/textured_large,
/area/station/command/heads_quarters/nt_rep)
"i" = (
/obj/structure/disposalpipe/segment,
/turf/closed/wall/r_wall,
/area/station/command/heads_quarters/nt_rep)
"j" = (
/obj/structure/cable,
/obj/machinery/atmospherics/components/unary/vent_pump/on/layer4,
/turf/open/floor/iron/dark/textured_large,
/area/station/command/heads_quarters/nt_rep)
"l" = (
/obj/structure/chair/comfy/beige{
	dir = 1
	},
/turf/open/floor/iron/dark/textured_large,
/area/station/command/heads_quarters/nt_rep)
"m" = (
/obj/structure/disposalpipe/segment{
	dir = 4
	},
/turf/open/floor/iron/dark/smooth_large,
/area/station/command/heads_quarters/nt_rep)
"n" = (
/obj/machinery/light/warm/dim/directional/west,
/obj/item/kirbyplants/random,
/turf/open/floor/iron/dark/textured_large,
/area/station/command/heads_quarters/nt_rep)
"p" = (
/obj/structure/chair/office/tactical{
	dir = 4
	},
/turf/open/floor/iron/dark/textured_large,
/area/station/command/heads_quarters/nt_rep)
"r" = (
/obj/structure/cable,
/turf/open/floor/iron/dark/textured_large,
/area/station/command/heads_quarters/nt_rep)
"s" = (
/obj/machinery/firealarm/directional/south,
/obj/machinery/atmospherics/components/unary/vent_scrubber/on/layer2{
	dir = 1
	},
/obj/machinery/vending/boozeomat,
/turf/open/floor/iron/dark/textured_large,
/area/station/command/heads_quarters/nt_rep)
"u" = (
/obj/machinery/firealarm/directional/west,
/turf/open/floor/iron/dark/textured_large,
/area/station/command/heads_quarters/nt_rep)
"v" = (
/obj/effect/landmark/start/nanotrasen_consultant,
/turf/open/floor/iron/dark/textured_large,
/area/station/command/heads_quarters/nt_rep)
"x" = (
/obj/machinery/photocopier/prebuilt,
/turf/open/floor/iron/dark/textured_large,
/area/station/command/heads_quarters/nt_rep)
"y" = (
/obj/effect/spawner/structure/window/reinforced,
/obj/machinery/door/poddoor/shutters/preopen{
	id = "nt_rep_priv";
	dir = 4;
	name = "Privacy Shutters"
	},
/turf/open/floor/plating,
/area/station/command/heads_quarters/nt_rep)
"z" = (
/obj/structure/cable,
/obj/machinery/atmospherics/pipe/smart/manifold4w/scrubbers/hidden/layer2,
/obj/structure/disposalpipe/segment{
	dir = 4
	},
/obj/machinery/atmospherics/pipe/smart/manifold4w/supply/hidden/layer4,
/turf/open/floor/iron/dark/textured_large,
/area/station/command/heads_quarters/nt_rep)
"A" = (
/obj/item/toy/crayon/white{
	pixel_y = -10;
	pixel_x = 10
	},
/turf/closed/wall/r_wall,
/area/station/command/heads_quarters/nt_rep)
"B" = (
/obj/machinery/light/warm/dim/directional/south,
/turf/open/floor/iron/dark/textured_large,
/area/station/command/heads_quarters/nt_rep)
"D" = (
/obj/machinery/atmospherics/pipe/smart/manifold4w/scrubbers/hidden/layer2,
/obj/structure/disposalpipe/segment{
	dir = 4
	},
/obj/structure/table/wood,
/obj/effect/spawner/random/bureaucracy/paper,
/obj/item/table_clock{
	pixel_y = 16
	},
/turf/open/floor/iron/dark/textured_large,
/area/station/command/heads_quarters/nt_rep)
"G" = (
/obj/machinery/power/apc/auto_name/directional/west,
/obj/structure/cable,
/turf/open/floor/iron/dark/textured_large,
/area/station/command/heads_quarters/nt_rep)
"H" = (
/turf/open/floor/iron/dark/textured_large,
/area/station/command/heads_quarters/nt_rep)
"I" = (
/obj/machinery/vending/cigarette,
/obj/effect/turf_decal/bot_white,
/turf/open/floor/iron/dark,
/area/station/hallway/primary/central)
"J" = (
/obj/machinery/door/poddoor/shutters/preopen{
	id = "nt_rep_priv";
	dir = 4;
	name = "Privacy Shutters"
	},
/obj/effect/spawner/structure/window/reinforced,
/turf/open/floor/plating,
/area/station/command/heads_quarters/nt_rep)
"K" = (
/obj/structure/table/reinforced,
/obj/item/stamp/centcom{
	pixel_x = -6;
	pixel_y = 8
	},
/obj/item/stamp/denied{
	pixel_x = -6;
	pixel_y = 4
	},
/obj/item/stamp{
	pixel_x = -6
	},
/obj/item/paper_bin{
	pixel_y = 4;
	pixel_x = 6
	},
/obj/item/pen/fountain{
	pixel_x = 6
	},
/turf/open/floor/iron/dark/textured_large,
/area/station/command/heads_quarters/nt_rep)
"L" = (
/obj/machinery/atmospherics/pipe/smart/manifold4w/scrubbers/hidden/layer2,
/obj/structure/disposalpipe/segment{
	dir = 4
	},
/obj/structure/table/wood,
/obj/effect/spawner/random/bureaucracy/paper,
/turf/open/floor/iron/dark/textured_large,
/area/station/command/heads_quarters/nt_rep)
"M" = (
/obj/machinery/atmospherics/pipe/smart/manifold4w/supply/hidden/layer4,
/obj/machinery/atmospherics/pipe/smart/manifold4w/scrubbers/hidden/layer2,
/obj/structure/cable,
/obj/structure/disposalpipe/segment{
	dir = 10
	},
/turf/open/floor/iron/dark,
/area/station/hallway/primary/central)
"P" = (
/obj/structure/filingcabinet,
/obj/structure/filingcabinet/medical{
	pixel_x = -10
	},
/obj/structure/filingcabinet/security{
	pixel_x = 10
	},
/turf/open/floor/iron/dark/textured_large,
/area/station/command/heads_quarters/nt_rep)
"Q" = (
/obj/machinery/airalarm/directional/south,
/obj/structure/chair/comfy/beige{
	dir = 1
	},
/turf/open/floor/iron/dark/textured_large,
/area/station/command/heads_quarters/nt_rep)
"S" = (
/obj/structure/table/reinforced,
/obj/machinery/fax{
	fax_name = "Nanotrasen Consultant's Office";
	name = "Nanotrasen Consultant's Fax Machine"
	},
/obj/structure/sign/calendar/directional/north,
/turf/open/floor/iron/dark/textured_large,
/area/station/command/heads_quarters/nt_rep)
"U" = (
/obj/effect/mapping_helpers/airlock/access/all/cent_com/rep_door,
/obj/machinery/door/airlock/maintenance,
/obj/structure/disposalpipe/segment{
	dir = 4
	},
/turf/open/floor/iron/dark/textured_large,
/area/station/command/heads_quarters/nt_rep)
"V" = (
/obj/machinery/modular_computer/preset/command,
/obj/machinery/light_switch/directional/east,
/obj/machinery/button/door/directional/east{
	pixel_y = 10;
	id = "nt_rep_priv"
	},
/turf/open/floor/iron/dark/textured_large,
/area/station/command/heads_quarters/nt_rep)
"W" = (
/obj/structure/chalkboard,
/turf/closed/wall/r_wall,
/area/station/command/heads_quarters/nt_rep)
"X" = (
/obj/machinery/atmospherics/pipe/smart/manifold4w/scrubbers/hidden/layer2,
/obj/machinery/holopad,
/obj/structure/disposalpipe/segment{
	dir = 4
	},
/obj/machinery/atmospherics/pipe/smart/manifold4w/supply/hidden/layer4,
/turf/open/floor/iron/dark/textured_large,
/area/station/command/heads_quarters/nt_rep)
"Y" = (
/turf/open/floor/iron/dark,
/area/station/hallway/primary/central)
"Z" = (
/obj/machinery/atmospherics/pipe/smart/manifold4w/supply/hidden/layer4,
/obj/machinery/atmospherics/pipe/smart/manifold4w/scrubbers/hidden/layer2,
/obj/structure/cable,
/obj/machinery/modular_computer/preset/time_clock/directional/west,
/obj/structure/disposalpipe/trunk{
	dir = 1
	},
/obj/machinery/disposal/bin,
/obj/effect/turf_decal/bot_white,
/turf/open/floor/iron/dark,
/area/station/hallway/primary/central)

(1,1,1) = {"
a
a
a
a
a
U
a
a
"}
(2,1,1) = {"
a
b
u
H
G
m
n
a
"}
(3,1,1) = {"
a
H
H
H
r
g
s
a
"}
(4,1,1) = {"
W
H
H
H
r
L
l
a
"}
(5,1,1) = {"
A
H
H
H
r
D
Q
a
"}
(6,1,1) = {"
a
S
K
P
j
X
B
a
"}
(7,1,1) = {"
a
V
p
v
r
z
x
a
"}
(8,1,1) = {"
a
a
J
y
y
c
i
i
"}
(9,1,1) = {"
a
I
Y
Y
Y
M
Z
a
"}
