//MAP CONVERTED BY dmm2tgm.py THIS HEADER COMMENT PREVENTS RECONVERSION, DO NOT REMOVE
"a" = (
/turf/closed/wall/r_wall,
/area/station/command/heads_quarters/nt_rep)
"b" = (
/obj/structure/table/wood,
/obj/effect/spawner/random/bureaucracy/folder{
	spawn_random_offset = 1
	},
/turf/open/floor/carpet/royalblue,
/area/station/command/heads_quarters/nt_rep)
"c" = (
/obj/effect/turf_decal/siding/wood{
	dir = 1
	},
/obj/structure/chair/wood{
	dir = 1
	},
/turf/open/floor/wood/large,
/area/station/command/heads_quarters/nt_rep)
"d" = (
/obj/item/storage/briefcase/central_command,
/obj/item/camera_film,
/obj/item/camera_film,
/obj/item/camera,
/obj/structure/sign/clock/directional/north,
/obj/item/tape,
/obj/item/tape,
/obj/item/taperecorder,
/obj/item/hand_labeler{
	pixel_y = 2
	},
/obj/item/storage/belt/sheath/sabre/cargo,
/obj/structure/closet/secure_closet/nanotrasen_consultant_new,
/turf/open/floor/carpet/executive,
/area/station/command/heads_quarters/nt_rep)
"e" = (
/obj/effect/turf_decal/siding/wood/corner,
/obj/effect/turf_decal/siding/wood/corner{
	dir = 8
	},
/obj/structure/chair/office{
	dir = 8
	},
/obj/effect/landmark/start/nanotrasen_crew_trainer,
/turf/open/floor/wood/large,
/area/station/command/heads_quarters/nt_rep)
"f" = (
/obj/machinery/holopad,
/turf/open/floor/wood/large,
/area/station/command/heads_quarters/nt_rep)
"g" = (
/obj/effect/turf_decal/siding/wood,
/turf/open/floor/wood/large,
/area/station/command/heads_quarters/nt_rep)
"h" = (
/obj/structure/chair/sofa/left/brown{
	dir = 4;
	color = "#462f1c"
	},
/turf/open/floor/carpet/royalblue,
/area/station/command/heads_quarters/nt_rep)
"i" = (
/obj/structure/hedge,
/obj/effect/turf_decal/siding/wood/end,
/turf/open/floor/wood/large,
/area/station/command/heads_quarters/nt_rep)
"j" = (
/obj/structure/extinguisher_cabinet/directional/south,
/obj/machinery/power/apc/auto_name/directional/east,
/obj/structure/cable,
/obj/structure/hedge,
/obj/effect/turf_decal/siding/wood{
	dir = 6
	},
/turf/open/floor/wood/large,
/area/station/command/heads_quarters/nt_rep)
"k" = (
/obj/effect/turf_decal/siding/wood{
	dir = 8
	},
/obj/structure/table/wood,
/obj/item/paper_bin{
	pixel_y = 5;
	pixel_x = -4
	},
/obj/item/pen{
	pixel_y = 5;
	pixel_x = -4
	},
/obj/item/stamp{
	pixel_y = 9;
	pixel_x = 8
	},
/obj/item/stamp/denied{
	pixel_x = 8;
	pixel_y = 2
	},
/obj/structure/window/reinforced/spawner/directional/west,
/turf/open/floor/wood/large,
/area/station/command/heads_quarters/nt_rep)
"l" = (
/obj/effect/turf_decal/siding/wood{
	dir = 5
	},
/obj/structure/hedge,
/turf/open/floor/wood/large,
/area/station/command/heads_quarters/nt_rep)
"m" = (
/obj/structure/sign/calendar/directional/south,
/obj/machinery/light/warm/directional/south,
/obj/machinery/atmospherics/components/unary/vent_scrubber/on/layer2{
	dir = 1
	},
/obj/effect/turf_decal/siding/wood,
/obj/structure/closet/secure_closet/nanotrasen_crew_trainer,
/obj/item/storage/lunchbox/nanotrasen,
/turf/open/floor/wood/large,
/area/station/command/heads_quarters/nt_rep)
"n" = (
/obj/machinery/status_display/evac/directional/north,
/obj/machinery/fax{
	fax_name = "Nanotrasen Consultant's Office";
	name = "Nanotrasen Consultant's Fax Machine"
	},
/obj/structure/table/wood/fancy/blue,
/turf/open/floor/carpet/executive,
/area/station/command/heads_quarters/nt_rep)
"o" = (
/obj/structure/safe/floor,
/obj/item/clothing/accessory/medal/gold/nanotrasen_consultant,
/obj/item/clothing/accessory/medal/silver/bureaucracy,
/obj/item/clothing/accessory/medal/gold/ordom,
/turf/open/floor/carpet/executive,
/area/station/command/heads_quarters/nt_rep)
"p" = (
/obj/effect/turf_decal/siding/wood{
	dir = 8
	},
/obj/effect/turf_decal/siding/wood/corner,
/obj/machinery/newscaster/directional/west,
/obj/structure/bed/dogbed/ian{
	name = "Lisa's bed";
	desc = "Lisa's bed! Looks comfy."
	},
/mob/living/basic/pet/dog/corgi/lisa,
/turf/open/floor/wood/large,
/area/station/command/heads_quarters/nt_rep)
"q" = (
/obj/effect/spawner/structure/window/reinforced,
/obj/structure/cable,
/obj/machinery/door/poddoor/shutters/preopen{
	id = "nt_rep_priv";
	dir = 4;
	name = "Privacy Shutters"
	},
/turf/open/floor/plating,
/area/station/command/heads_quarters/nt_rep)
"r" = (
/obj/machinery/atmospherics/pipe/smart/manifold4w/supply/hidden/layer4,
/obj/machinery/atmospherics/pipe/smart/manifold4w/scrubbers/hidden/layer2,
/obj/effect/turf_decal/siding/wood/corner{
	dir = 4
	},
/obj/effect/turf_decal/siding/wood/corner{
	dir = 8
	},
/turf/open/floor/wood/large,
/area/station/command/heads_quarters/nt_rep)
"s" = (
/obj/structure/cable,
/obj/machinery/atmospherics/pipe/smart/manifold4w/supply/hidden/layer4,
/obj/machinery/atmospherics/pipe/smart/manifold4w/scrubbers/hidden/layer2,
/obj/structure/disposalpipe/segment,
/obj/effect/turf_decal/tile/neutral{
	dir = 8
	},
/turf/open/floor/iron,
/area/station/hallway/primary/central)
"t" = (
/obj/structure/chair/comfy/brown,
/obj/effect/landmark/start/nanotrasen_consultant,
/turf/open/floor/carpet/executive,
/area/station/command/heads_quarters/nt_rep)
"u" = (
/obj/effect/turf_decal/siding/wood/end{
	dir = 1
	},
/obj/machinery/button/door/directional/west{
	id = "nt_rep_priv";
	name = "Privacy Shutters Control";
	req_access = list("cent_general")
	},
/obj/structure/filingcabinet/employment{
	name = "employment forms filing cabinet"
	},
/obj/structure/filingcabinet/medical{
	pixel_x = -10;
	icon_state = "employmentcabinet";
	name = "medical records filing cabinet"
	},
/obj/structure/filingcabinet/security{
	pixel_x = 10;
	icon_state = "employmentcabinet";
	name = "security records filing cabinet"
	},
/turf/open/floor/wood/large,
/area/station/command/heads_quarters/nt_rep)
"v" = (
/obj/machinery/atmospherics/pipe/smart/manifold4w/supply/hidden/layer4,
/obj/machinery/atmospherics/pipe/smart/manifold4w/scrubbers/hidden/layer2,
/obj/effect/turf_decal/siding/wood,
/obj/effect/landmark/start/nanotrasen_crew_trainer,
/turf/open/floor/wood/large,
/area/station/command/heads_quarters/nt_rep)
"w" = (
/obj/machinery/door/airlock/maintenance,
/obj/effect/mapping_helpers/airlock/access/all/cent_com/rep_door,
/turf/open/floor/iron/dark/smooth_large,
/area/station/command/heads_quarters/nt_rep)
"x" = (
/obj/effect/turf_decal/siding/wood{
	dir = 1
	},
/turf/open/floor/wood/large,
/area/station/command/heads_quarters/nt_rep)
"y" = (
/obj/effect/spawner/structure/window/reinforced,
/obj/structure/cable,
/obj/machinery/door/poddoor/shutters/preopen{
	id = "nt_rep_priv";
	dir = 1;
	name = "Privacy Shutters"
	},
/turf/open/floor/plating,
/area/station/command/heads_quarters/nt_rep)
"z" = (
/obj/structure/chair/sofa/right/brown{
	dir = 8;
	color = "#462f1c"
	},
/turf/open/floor/carpet/royalblue,
/area/station/command/heads_quarters/nt_rep)
"A" = (
/obj/structure/table/reinforced/titaniumglass,
/obj/item/clipboard{
	pixel_y = 3;
	pixel_x = -5
	},
/obj/item/folder/blue{
	pixel_y = 2;
	pixel_x = -4
	},
/obj/item/reagent_containers/cup/glass/mug/nanotrasen{
	pixel_y = 11;
	pixel_x = 11
	},
/obj/item/sign/flag/nanotrasen{
	pixel_x = 5
	},
/turf/open/floor/carpet/executive,
/area/station/command/heads_quarters/nt_rep)
"B" = (
/obj/item/paper_bin{
	pixel_y = 5;
	pixel_x = -4
	},
/obj/item/stamp{
	pixel_y = 12;
	pixel_x = 8
	},
/obj/item/stamp/denied{
	pixel_x = 8;
	pixel_y = 6
	},
/obj/structure/table/reinforced/titaniumglass,
/obj/item/stamp/nanotrasen{
	pixel_x = 8
	},
/obj/item/pen/fountain/nanotrasen{
	pixel_y = 5;
	pixel_x = -4
	},
/obj/machinery/requests_console/directional/east{
	name = "Nanotrasen Consultant's Requests Console";
	department = "Nanotrasen Consultant's Desk"
	},
/obj/effect/mapping_helpers/requests_console/announcement,
/obj/effect/mapping_helpers/requests_console/information,
/obj/effect/mapping_helpers/requests_console/assistance,
/turf/open/floor/carpet/executive,
/area/station/command/heads_quarters/nt_rep)
"C" = (
/obj/structure/chair/sofa/right/brown{
	dir = 4;
	color = "#462f1c"
	},
/obj/machinery/airalarm/directional/west,
/obj/item/radio/intercom/directional/south,
/turf/open/floor/carpet/royalblue,
/area/station/command/heads_quarters/nt_rep)
"D" = (
/obj/machinery/atmospherics/pipe/smart/manifold4w/supply/hidden/layer4,
/obj/machinery/atmospherics/pipe/smart/manifold4w/scrubbers/hidden/layer2,
/obj/effect/turf_decal/siding/wood{
	dir = 1
	},
/turf/open/floor/wood/large,
/area/station/command/heads_quarters/nt_rep)
"E" = (
/obj/machinery/firealarm/directional/south,
/obj/effect/turf_decal/siding/wood{
	dir = 10
	},
/obj/structure/table/wood,
/obj/item/clipboard{
	pixel_y = 3;
	pixel_x = 2
	},
/obj/item/folder/yellow{
	pixel_y = 1;
	pixel_x = -2
	},
/obj/structure/window/reinforced/spawner/directional/west,
/turf/open/floor/wood/large,
/area/station/command/heads_quarters/nt_rep)
"F" = (
/obj/effect/turf_decal/siding/wood/corner{
	dir = 4
	},
/obj/effect/turf_decal/siding/wood{
	dir = 8
	},
/turf/open/floor/wood/large,
/area/station/command/heads_quarters/nt_rep)
"G" = (
/obj/machinery/atmospherics/pipe/smart/manifold4w/supply/hidden/layer4,
/obj/machinery/atmospherics/pipe/smart/manifold4w/scrubbers/hidden/layer2,
/obj/effect/turf_decal/siding/wood/corner{
	dir = 4
	},
/turf/open/floor/wood/large,
/area/station/command/heads_quarters/nt_rep)
"I" = (
/obj/machinery/modular_computer/preset/command{
	dir = 8
	},
/turf/open/floor/carpet/executive,
/area/station/command/heads_quarters/nt_rep)
"J" = (
/obj/machinery/atmospherics/components/unary/vent_pump/on/layer4,
/obj/effect/turf_decal/siding/wood{
	dir = 1
	},
/turf/open/floor/wood/large,
/area/station/command/heads_quarters/nt_rep)
"K" = (
/obj/structure/table/reinforced/titaniumglass,
/obj/item/flashlight/lamp/green{
	pixel_y = 13;
	pixel_x = -6
	},
/obj/item/phone{
	pixel_x = -4;
	pixel_y = -1
	},
/obj/machinery/recharger{
	pixel_y = 3;
	pixel_x = 7
	},
/turf/open/floor/carpet/executive,
/area/station/command/heads_quarters/nt_rep)
"L" = (
/obj/machinery/atmospherics/pipe/smart/manifold4w/supply/hidden/layer4,
/obj/machinery/atmospherics/pipe/smart/manifold4w/scrubbers/hidden/layer2,
/obj/effect/turf_decal/siding/wood{
	dir = 5
	},
/obj/machinery/photocopier/prebuilt,
/obj/item/toy/plush/skyrat/ian/lisa{
	pixel_y = 11
	},
/turf/open/floor/wood/large,
/area/station/command/heads_quarters/nt_rep)
"M" = (
/obj/machinery/status_display/evac/directional/west,
/obj/structure/cable,
/obj/machinery/atmospherics/pipe/smart/manifold4w/supply/hidden/layer4,
/obj/machinery/atmospherics/pipe/smart/manifold4w/scrubbers/hidden/layer2,
/obj/structure/disposalpipe/segment,
/turf/open/floor/iron,
/area/station/hallway/primary/central)
"N" = (
/obj/machinery/modular_computer/preset/time_clock/directional/south,
/turf/template_noop,
/area/station/hallway/primary/central)
"O" = (
/obj/effect/turf_decal/siding/wood/end,
/obj/machinery/modular_computer/preset/civilian{
	dir = 1
	},
/obj/machinery/status_display/ai/directional/south,
/turf/open/floor/wood/large,
/area/station/command/heads_quarters/nt_rep)
"P" = (
/obj/structure/table/wood,
/obj/item/taperecorder{
	pixel_y = 2;
	pixel_x = -5
	},
/obj/item/tape{
	pixel_x = 4
	},
/obj/machinery/vending/boozeomat{
	pixel_y = -32;
	density = 0;
	req_access = list("cent_general")
	},
/obj/machinery/light/directional/south,
/turf/open/floor/carpet/royalblue,
/area/station/command/heads_quarters/nt_rep)
"Q" = (
/obj/machinery/atmospherics/pipe/smart/manifold4w/supply/hidden/layer4,
/obj/machinery/atmospherics/pipe/smart/manifold4w/scrubbers/hidden/layer2,
/obj/structure/cable,
/obj/effect/turf_decal/siding/wood{
	dir = 1
	},
/obj/effect/turf_decal/siding/wood/corner,
/turf/open/floor/wood/large,
/area/station/command/heads_quarters/nt_rep)
"R" = (
/obj/machinery/atmospherics/pipe/smart/manifold4w/supply/hidden/layer4,
/obj/machinery/atmospherics/pipe/smart/manifold4w/scrubbers/hidden/layer2,
/obj/structure/cable,
/obj/machinery/light_switch/directional/east,
/obj/effect/turf_decal/siding/wood/end{
	dir = 4
	},
/turf/open/floor/wood/large,
/area/station/command/heads_quarters/nt_rep)
"S" = (
/turf/template_noop,
/area/station/hallway/primary/port)
"T" = (
/obj/effect/turf_decal/siding/wood{
	dir = 4
	},
/obj/effect/turf_decal/siding/wood{
	dir = 8
	},
/obj/structure/sign/poster/official/nanotrasen_logo/directional/west,
/turf/open/floor/wood/large,
/area/station/command/heads_quarters/nt_rep)
"U" = (
/obj/effect/turf_decal/tile/neutral{
	dir = 8
	},
/obj/structure/cable,
/obj/machinery/atmospherics/pipe/smart/manifold4w/supply/hidden/layer4,
/obj/machinery/atmospherics/pipe/smart/manifold4w/scrubbers/hidden/layer2,
/obj/structure/disposalpipe/segment{
	dir = 5
	},
/turf/open/floor/iron,
/area/station/hallway/primary/central)
"V" = (
/turf/template_noop,
/area/template_noop)
"W" = (
/obj/structure/chair/sofa/left/brown{
	dir = 8;
	color = "#462f1c"
	},
/obj/structure/sign/poster/official/enlist/directional/south,
/obj/machinery/camera/autoname/directional/south,
/turf/open/floor/carpet/royalblue,
/area/station/command/heads_quarters/nt_rep)
"X" = (
/obj/effect/turf_decal/siding/wood{
	dir = 4
	},
/obj/effect/turf_decal/siding/wood{
	dir = 8
	},
/obj/structure/noticeboard/directional/west{
	name = "Nanotrasen Consultant's Notice Board"
	},
/obj/machinery/light/directional/west,
/turf/open/floor/wood/large,
/area/station/command/heads_quarters/nt_rep)
"Y" = (
/obj/machinery/door/firedoor,
/obj/structure/cable,
/obj/machinery/atmospherics/pipe/smart/manifold4w/scrubbers/hidden/layer2,
/obj/machinery/atmospherics/pipe/smart/manifold4w/supply/hidden/layer4,
/obj/effect/mapping_helpers/airlock/access/all/cent_com/rep_door,
/obj/machinery/door/airlock/corporate{
	name = "Nanotrasen Internal Affairs Office"
	},
/obj/effect/landmark/navigate_destination/autoname,
/obj/effect/mapping_helpers/airlock/unres,
/turf/open/floor/iron/dark/smooth_large,
/area/station/command/heads_quarters/nt_rep)
"Z" = (
/obj/machinery/keycard_auth/wall_mounted/directional/north,
/obj/structure/aquarium/prefilled,
/obj/item/reagent_containers/cup/fish_feed{
	pixel_y = 17;
	pixel_x = -3
	},
/turf/open/floor/carpet/executive,
/area/station/command/heads_quarters/nt_rep)

(1,1,1) = {"
V
a
a
a
a
w
a
a
a
V
V
"}
(2,1,1) = {"
S
a
u
X
T
F
p
i
a
a
V
"}
(3,1,1) = {"
S
a
d
o
K
x
g
h
C
a
V
"}
(4,1,1) = {"
S
a
n
t
A
c
g
b
P
a
V
"}
(5,1,1) = {"
S
a
Z
I
B
J
v
z
W
a
V
"}
(6,1,1) = {"
S
a
q
q
a
l
r
k
E
a
a
"}
(7,1,1) = {"
V
M
s
U
y
y
D
f
e
O
a
"}
(8,1,1) = {"
V
V
V
V
V
y
L
G
m
a
a
"}
(9,1,1) = {"
V
V
V
V
V
y
y
Q
j
a
V
"}
(10,1,1) = {"
V
V
V
V
V
V
Y
R
a
a
V
"}
(11,1,1) = {"
V
V
V
V
V
N
a
a
a
V
V
"}
