//MAP CONVERTED BY dmm2tgm.py THIS HEADER COMMENT PREVENTS RECONVERSION, DO NOT REMOVE
"aH" = (
/obj/structure/decorative/shelf/soda_multipacks,
/turf/open/floor/wood,
/area/ruin/space/has_grav)
"aK" = (
/obj/structure/flora/grass/both/style_random,
/turf/open/misc/asteroid/snow/icemoon,
/area/ruin/space/has_grav)
"bj" = (
/turf/open/misc/asteroid/snow/icemoon,
/area/ruin/space/has_grav)
"br" = (
/obj/effect/overlay/light_snow,
/obj/structure/bonfire/prelit,
/turf/open/misc/dirt/icemoon,
/area/ruin/space/has_grav)
"dw" = (
/obj/effect/spawner/structure/window/ice,
/obj/structure/barricade/wooden/crude/snow,
/obj/structure/curtain/bounty/start_closed,
/turf/open/floor/wood,
/area/ruin/space/has_grav)
"fB" = (
/turf/closed/wall/mineral/wood,
/area/ruin/space/has_grav)
"gu" = (
/obj/structure/sign/poster/contraband/soviet_propaganda,
/turf/closed/wall/mineral/wood,
/area/ruin/space/has_grav)
"gQ" = (
/obj/structure/flora/grass/brown/style_random,
/obj/effect/overlay/light_snow,
/turf/open/misc/asteroid/snow/icemoon,
/area/ruin/space/has_grav)
"hx" = (
/obj/structure/flora/grass/both/style_random,
/obj/effect/overlay/light_snow,
/turf/open/misc/asteroid/snow/icemoon,
/area/ruin/space/has_grav)
"hA" = (
/obj/structure/rack/wooden,
/obj/item/gun/ballistic/rifle/boltaction{
	pixel_x = -7;
	pixel_y = 6
	},
/obj/item/ammo_box/speedloader/strilka310/surplus{
	pixel_x = 5;
	pixel_y = -7
	},
/obj/item/ammo_box/speedloader/strilka310/surplus{
	pixel_x = -8;
	pixel_y = -8
	},
/obj/item/ammo_box/speedloader/strilka310/surplus{
	pixel_x = 5;
	pixel_y = -1
	},
/obj/item/ammo_box/speedloader/strilka310/surplus{
	pixel_x = 0;
	pixel_y = -10
	},
/obj/item/ammo_box/speedloader/strilka310/surplus{
	pixel_x = -7;
	pixel_y = -1
	},
/turf/open/floor/wood,
/area/ruin/space/has_grav)
"jM" = (
/obj/effect/overlay/light_snow,
/obj/structure/flora/grass/both/style_random,
/turf/open/misc/asteroid/snow/icemoon,
/area/ruin/space/has_grav)
"kr" = (
/obj/structure/closet/crate/wooden,
/obj/item/stack/sheet/mineral/plasma/thirty,
/obj/item/stack/sheet/mineral/gold{
	amount = 20
	},
/obj/item/stack/sheet/mineral/silver{
	amount = 25
	},
/obj/item/stack/sheet/iron/fifty,
/obj/item/stack/sheet/mineral/uranium/five,
/obj/item/stack/sheet/bluespace_crystal{
	amount = 5
	},
/turf/open/floor/wood,
/area/ruin/space/has_grav)
"kH" = (
/obj/item/gps/spaceruin{
	pixel_x = 5;
	pixel_y = 8
	},
/turf/open/floor/wood,
/area/ruin/space/has_grav)
"kX" = (
/obj/effect/overlay/light_snow,
/mob/living/basic/mining/watcher/icewing,
/turf/open/misc/asteroid/snow/icemoon,
/area/ruin/space/has_grav)
"nD" = (
/obj/effect/overlay/light_snow,
/obj/item/circuitboard/computer/teleporter,
/mob/living/basic/mining/ice_demon,
/turf/open/floor/fakeice/slippery,
/area/ruin/space/has_grav)
"pE" = (
/obj/structure/flora/rock/pile/icy/style_random,
/obj/item/storage/backpack/duffelbag/syndie/nri/captain,
/obj/effect/overlay/light_snow,
/turf/open/misc/asteroid/snow/icemoon,
/area/ruin/space/has_grav)
"pT" = (
/obj/effect/overlay/light_snow,
/mob/living/basic/mining/ice_whelp,
/turf/open/misc/asteroid/snow/icemoon,
/area/ruin/space/has_grav)
"qJ" = (
/obj/item/crowbar/red{
	pixel_x = 4;
	pixel_y = 3
	},
/obj/item/reagent_containers/cup/glass/bottle/vodka/badminka{
	pixel_x = -6;
	pixel_y = 12
	},
/obj/item/cigarette/cigar/premium{
	pixel_x = 3;
	pixel_y = 8
	},
/obj/structure/table/wood,
/turf/open/floor/wood,
/area/ruin/space/has_grav)
"rd" = (
/obj/effect/overlay/light_snow,
/obj/structure/spawner/ice_moon/demonic_portal/ice_whelp,
/turf/open/misc/asteroid/snow/icemoon,
/area/ruin/space/has_grav)
"rw" = (
/obj/effect/decal/cleanable/blood/old,
/turf/open/floor/wood,
/area/ruin/space/has_grav)
"rX" = (
/obj/item/flashlight/flare,
/turf/open/floor/wood,
/area/ruin/space/has_grav)
"sO" = (
/obj/effect/overlay/light_snow,
/mob/living/basic/mining/wolf,
/turf/open/misc/asteroid/snow/icemoon,
/area/ruin/space/has_grav)
"tK" = (
/obj/effect/decal/cleanable/blood/oil,
/turf/open/floor/wood,
/area/ruin/space/has_grav)
"tT" = (
/obj/effect/overlay/light_snow,
/mob/living/basic/mining/ice_demon,
/turf/open/misc/asteroid/snow/icemoon,
/area/ruin/space/has_grav)
"uZ" = (
/obj/structure/rack/shelf,
/obj/item/reagent_containers/hypospray/medipen/survival/luxury{
	pixel_x = 0;
	pixel_y = -8
	},
/obj/item/survivalcapsule/medical{
	pixel_x = 0;
	pixel_y = 0
	},
/turf/open/floor/wood,
/area/ruin/space/has_grav)
"vo" = (
/obj/effect/mapping_helpers/broken_floor,
/obj/item/flashlight/lantern/on,
/turf/open/floor/wood,
/area/ruin/space/has_grav)
"vF" = (
/obj/structure/flora/rock/pile/icy/style_random,
/obj/effect/overlay/light_snow,
/turf/open/misc/asteroid/snow/icemoon,
/area/ruin/space/has_grav)
"vZ" = (
/obj/effect/decal/cleanable/blood/gibs/robot_debris/old,
/turf/open/floor/wood,
/area/ruin/space/has_grav)
"wh" = (
/obj/structure/decorative/shelf/crates,
/turf/open/floor/wood,
/area/ruin/space/has_grav)
"wD" = (
/obj/structure/rack/wooden,
/obj/structure/sign/poster/contraband/nri_pistol/directional/east,
/obj/item/clothing/mask/gas{
	pixel_x = 6;
	pixel_y = 7
	},
/obj/item/clothing/mask/gas{
	pixel_x = 8;
	pixel_y = -7
	},
/obj/item/clothing/mask/gas{
	pixel_x = -7;
	pixel_y = 8
	},
/turf/open/floor/wood,
/area/ruin/space/has_grav)
"wR" = (
/obj/effect/overlay/light_snow,
/obj/structure/flora/scrap,
/turf/open/misc/asteroid/snow/icemoon,
/area/ruin/space/has_grav)
"xF" = (
/obj/effect/mapping_helpers/broken_floor,
/turf/open/floor/wood,
/area/ruin/space/has_grav)
"yh" = (
/obj/machinery/door/airlock/hatch,
/obj/structure/fans/tiny,
/turf/open/floor/wood,
/area/ruin/space/has_grav)
"yB" = (
/obj/machinery/door/airlock/hatch,
/obj/structure/fans/tiny{
	uses_integrity = 0
	},
/turf/open/misc/asteroid/snow/icemoon,
/area/ruin/space/has_grav)
"yP" = (
/obj/structure/frame/computer,
/turf/open/floor/wood,
/area/ruin/space/has_grav)
"yX" = (
/obj/effect/overlay/light_snow,
/turf/open/floor/plating/snowed/icemoon,
/area/ruin/space/has_grav)
"yZ" = (
/obj/item/tank/internals/emergency_oxygen/engi,
/turf/open/floor/wood,
/area/ruin/space/has_grav)
"zd" = (
/obj/effect/overlay/light_snow,
/obj/item/storage/toolbox/electrical{
	pixel_x = 1;
	pixel_y = -1
	},
/turf/open/misc/asteroid/snow/icemoon,
/area/ruin/space/has_grav)
"zC" = (
/obj/item/paper/crumpled{
	pixel_x = 4;
	pixel_y = 11;
	default_raw_text = "Some fucked shit happened and I don't think we're on that blasted piece of shit moon anymore. I don't think we're anywhere anymore. Pavel went to scrounge up resources to repair this shit teleporter, but he's been gone for hours. This might be it."
	},
/obj/item/flashlight/flare/candle/infinite{
	pixel_x = -9;
	pixel_y = -3
	},
/turf/open/floor/wood,
/area/ruin/space/has_grav)
"zQ" = (
/obj/machinery/teleport/hub,
/turf/open/floor/wood,
/area/ruin/space/has_grav)
"Bq" = (
/obj/structure/decorative/shelf/soda_milk,
/turf/open/floor/wood,
/area/ruin/space/has_grav)
"Cv" = (
/obj/structure/flora/tree/pine/style_random,
/obj/effect/overlay/light_snow,
/turf/open/misc/asteroid/snow/icemoon,
/area/ruin/space/has_grav)
"DZ" = (
/obj/structure/decorative/shelf/alcohol,
/turf/open/floor/wood,
/area/ruin/space/has_grav)
"Ep" = (
/obj/structure/rack/wooden,
/obj/item/storage/box/colonial_rations{
	pixel_x = -6;
	pixel_y = 8
	},
/obj/item/storage/box/colonial_rations{
	pixel_x = -6;
	pixel_y = -7
	},
/obj/item/storage/box/colonial_rations{
	pixel_x = 7;
	pixel_y = -6
	},
/turf/open/floor/wood,
/area/ruin/space/has_grav)
"EN" = (
/obj/effect/overlay/light_snow,
/obj/effect/mine/explosive/nri,
/turf/open/misc/asteroid/snow/icemoon,
/area/ruin/space/has_grav)
"FK" = (
/obj/effect/overlay/light_snow,
/obj/effect/mob_spawn/corpse/human/russian,
/turf/open/lava/plasma/ice_moon,
/area/ruin/space/has_grav)
"FR" = (
/obj/structure/lattice/catwalk,
/obj/structure/railing,
/obj/structure/railing{
	dir = 1
	},
/obj/effect/overlay/light_snow,
/turf/open/lava/plasma/ice_moon,
/area/ruin/space/has_grav)
"Js" = (
/obj/item/beacon{
	name = "Mysterious Signal"
	},
/turf/open/floor/wood,
/area/ruin/space/has_grav)
"JB" = (
/obj/item/reagent_containers/cup/glass/bottle/vodka{
	pixel_x = 1;
	pixel_y = 5
	},
/obj/item/reagent_containers/cup/glass/bottle/vodka{
	pixel_x = 10;
	pixel_y = 10
	},
/obj/item/flashlight/lantern/on{
	pixel_x = -9;
	pixel_y = 8
	},
/obj/structure/table/wood,
/turf/open/floor/wood,
/area/ruin/space/has_grav)
"Lb" = (
/obj/effect/overlay/light_snow,
/turf/open/lava/plasma/ice_moon,
/area/ruin/space/has_grav)
"LU" = (
/obj/machinery/teleport/station,
/turf/open/floor/wood,
/area/ruin/space/has_grav)
"MR" = (
/obj/effect/mob_spawn/corpse/human/russian,
/turf/open/floor/wood,
/area/ruin/space/has_grav)
"Ne" = (
/obj/effect/overlay/light_snow,
/obj/effect/mob_spawn/corpse/human/russian,
/turf/open/floor/fakeice/slippery,
/area/ruin/space/has_grav)
"On" = (
/turf/closed/indestructible/rock/snow/ice/ore,
/area/ruin/space/has_grav)
"OB" = (
/obj/structure/decorative/shelf,
/obj/item/pickaxe/rusted{
	pixel_x = -6;
	pixel_y = 6
	},
/obj/item/storage/bag/ore{
	pixel_x = 1;
	pixel_y = -8
	},
/turf/open/floor/wood,
/area/ruin/space/has_grav)
"Pr" = (
/obj/effect/overlay/light_snow,
/obj/structure/flora/tree/stump,
/turf/open/misc/asteroid/snow/icemoon,
/area/ruin/space/has_grav)
"QE" = (
/obj/item/clothing/suit/hooded/wintercoat{
	pixel_x = 8;
	pixel_y = -5
	},
/obj/item/clothing/shoes/winterboots/ice_boots{
	pixel_x = -8;
	pixel_y = -5
	},
/obj/structure/rack/wooden,
/obj/item/clothing/shoes/winterboots/ice_boots{
	pixel_x = 4;
	pixel_y = 10
	},
/obj/item/clothing/suit/hooded/wintercoat{
	pixel_x = -7;
	pixel_y = 9
	},
/turf/open/floor/wood,
/area/ruin/space/has_grav)
"QL" = (
/obj/structure/sign/flag/nri,
/turf/closed/wall/mineral/wood,
/area/ruin/space/has_grav)
"QR" = (
/obj/effect/overlay/light_snow,
/turf/open/floor/fakeice/slippery,
/area/ruin/space/has_grav)
"Rt" = (
/obj/effect/overlay/light_snow,
/obj/structure/flora/rock/pile/icy/style_random,
/turf/open/misc/asteroid/snow/icemoon,
/area/ruin/space/has_grav)
"Tq" = (
/obj/structure/grandfatherclock,
/turf/open/floor/wood,
/area/ruin/space/has_grav)
"TH" = (
/turf/template_noop,
/area/template_noop)
"Uh" = (
/obj/effect/overlay/light_snow,
/obj/structure/flora/tree/dead/style_random,
/turf/open/misc/asteroid/snow/icemoon,
/area/ruin/space/has_grav)
"Us" = (
/obj/effect/overlay/light_snow,
/obj/effect/mob_spawn/corpse/human/russian,
/turf/open/misc/asteroid/snow/icemoon,
/area/ruin/space/has_grav)
"WZ" = (
/obj/effect/overlay/light_snow,
/turf/open/misc/asteroid/snow/icemoon,
/area/ruin/space/has_grav)
"Xr" = (
/obj/structure/table/wood,
/turf/open/floor/wood,
/area/ruin/space/has_grav)
"XD" = (
/turf/open/floor/wood,
/area/ruin/space/has_grav)
"Zb" = (
/obj/structure/flora/rock/pile/icy/style_random,
/turf/open/misc/asteroid/snow/icemoon,
/area/ruin/space/has_grav)
"Zo" = (
/obj/item/shard{
	icon_state = "medium"
	},
/turf/open/floor/wood,
/area/ruin/space/has_grav)
"Zz" = (
/obj/effect/overlay/light_snow,
/obj/effect/turf_decal/weather/snow,
/turf/open/misc/dirt/icemoon,
/area/ruin/space/has_grav)
"ZC" = (
/obj/structure/decorative/shelf/milk,
/turf/open/floor/wood,
/area/ruin/space/has_grav)

(1,1,1) = {"
TH
TH
TH
TH
TH
TH
TH
TH
TH
On
On
On
TH
TH
TH
TH
TH
TH
TH
TH
TH
TH
On
On
On
On
On
TH
On
On
On
On
On
TH
TH
TH
"}
(2,1,1) = {"
TH
TH
TH
TH
TH
TH
TH
On
On
On
On
On
On
On
TH
TH
TH
TH
TH
TH
TH
On
On
On
On
On
On
On
On
On
On
On
On
On
TH
TH
"}
(3,1,1) = {"
TH
TH
TH
TH
On
On
On
On
On
bj
Cv
On
On
On
On
On
TH
TH
TH
TH
On
On
On
vF
WZ
On
On
On
On
On
On
On
On
On
TH
TH
"}
(4,1,1) = {"
TH
TH
TH
On
On
On
On
On
WZ
WZ
WZ
WZ
QR
On
On
On
On
TH
TH
On
On
On
QR
WZ
WZ
WZ
WZ
On
vF
On
On
On
On
On
TH
TH
"}
(5,1,1) = {"
TH
TH
On
On
On
WZ
WZ
WZ
Cv
WZ
WZ
WZ
WZ
WZ
vF
On
On
On
yB
On
On
On
QR
WZ
Cv
hx
WZ
WZ
WZ
WZ
On
On
On
On
On
TH
"}
(6,1,1) = {"
TH
On
On
On
vF
WZ
WZ
WZ
WZ
Cv
hx
WZ
WZ
Cv
WZ
WZ
On
On
WZ
On
WZ
QR
WZ
WZ
WZ
WZ
WZ
WZ
Cv
WZ
WZ
QR
On
On
On
TH
"}
(7,1,1) = {"
TH
On
On
On
WZ
WZ
Cv
WZ
WZ
WZ
wR
WZ
WZ
WZ
pE
WZ
WZ
Cv
WZ
vF
WZ
WZ
WZ
WZ
Cv
WZ
WZ
WZ
WZ
WZ
Uh
WZ
vF
On
On
On
"}
(8,1,1) = {"
TH
On
On
On
WZ
WZ
WZ
vF
WZ
gQ
WZ
WZ
Cv
gQ
hx
WZ
WZ
WZ
WZ
WZ
WZ
WZ
WZ
vF
WZ
hx
WZ
WZ
Cv
WZ
hx
WZ
gQ
On
On
On
"}
(9,1,1) = {"
TH
On
On
WZ
WZ
WZ
Cv
WZ
WZ
hx
WZ
WZ
WZ
sO
WZ
WZ
WZ
WZ
hx
WZ
WZ
WZ
Cv
WZ
wR
WZ
zd
WZ
hx
pT
vF
WZ
WZ
WZ
On
On
"}
(10,1,1) = {"
On
On
On
WZ
WZ
WZ
WZ
WZ
Cv
WZ
WZ
QR
WZ
WZ
WZ
Uh
WZ
WZ
Cv
WZ
QR
WZ
WZ
WZ
WZ
Cv
WZ
WZ
WZ
Cv
WZ
WZ
Cv
gQ
On
On
"}
(11,1,1) = {"
On
On
QR
WZ
WZ
Cv
WZ
WZ
WZ
fB
dw
dw
fB
WZ
WZ
WZ
gQ
WZ
WZ
WZ
WZ
WZ
Pr
gQ
WZ
WZ
WZ
Cv
WZ
gQ
WZ
WZ
WZ
WZ
On
On
"}
(12,1,1) = {"
On
On
QR
WZ
WZ
WZ
WZ
WZ
fB
fB
Tq
Xr
fB
fB
gQ
vF
WZ
WZ
WZ
Cv
WZ
hx
WZ
WZ
WZ
gQ
WZ
WZ
Uh
WZ
WZ
Cv
hx
WZ
On
On
"}
(13,1,1) = {"
On
On
On
On
WZ
kX
WZ
fB
QL
yZ
XD
XD
hA
fB
fB
WZ
WZ
WZ
WZ
WZ
WZ
Uh
WZ
WZ
Cv
WZ
gQ
WZ
WZ
WZ
WZ
WZ
WZ
QR
On
On
"}
(14,1,1) = {"
TH
On
On
On
QR
WZ
WZ
fB
yP
Zo
rX
MR
rw
XD
fB
WZ
WZ
hx
Zz
WZ
WZ
WZ
wR
WZ
WZ
WZ
WZ
Cv
WZ
vF
WZ
WZ
On
On
On
TH
"}
(15,1,1) = {"
TH
TH
yB
WZ
WZ
WZ
WZ
fB
LU
vZ
Js
zC
XD
XD
yh
WZ
WZ
Zz
br
Zz
WZ
tT
WZ
hx
WZ
WZ
WZ
WZ
hx
WZ
WZ
On
On
On
TH
TH
"}
(16,1,1) = {"
TH
TH
On
On
WZ
WZ
WZ
fB
zQ
XD
XD
kH
XD
QE
fB
hx
WZ
WZ
Zz
QR
WZ
WZ
Cv
WZ
WZ
Cv
QR
WZ
WZ
WZ
On
On
On
TH
TH
TH
"}
(17,1,1) = {"
TH
On
On
On
WZ
WZ
Cv
fB
gu
Ep
tK
XD
wD
fB
fB
WZ
WZ
WZ
WZ
QR
QR
WZ
EN
WZ
WZ
WZ
WZ
WZ
WZ
Cv
On
On
On
TH
TH
TH
"}
(18,1,1) = {"
TH
On
On
On
vF
WZ
WZ
WZ
fB
fB
qJ
JB
fB
fB
WZ
Cv
WZ
WZ
WZ
WZ
Cv
WZ
WZ
WZ
vF
WZ
WZ
Cv
WZ
WZ
vF
On
On
TH
TH
TH
"}
(19,1,1) = {"
TH
TH
On
On
On
WZ
WZ
WZ
WZ
fB
dw
dw
fB
gQ
WZ
WZ
hx
WZ
WZ
WZ
hx
WZ
WZ
Cv
WZ
sO
WZ
WZ
WZ
WZ
On
On
On
On
TH
TH
"}
(20,1,1) = {"
TH
TH
On
On
On
WZ
WZ
WZ
Cv
WZ
WZ
WZ
Cv
WZ
WZ
WZ
WZ
WZ
Cv
WZ
WZ
WZ
WZ
hx
WZ
WZ
hx
WZ
WZ
gQ
WZ
On
On
On
TH
TH
"}
(21,1,1) = {"
TH
TH
On
On
On
gQ
WZ
WZ
WZ
WZ
WZ
WZ
vF
WZ
WZ
Cv
WZ
WZ
WZ
QR
WZ
WZ
Cv
WZ
WZ
gQ
WZ
WZ
WZ
WZ
Lb
Lb
On
On
On
TH
"}
(22,1,1) = {"
TH
TH
On
On
On
WZ
vF
WZ
WZ
Uh
gQ
WZ
WZ
QR
WZ
WZ
WZ
hx
WZ
WZ
WZ
WZ
WZ
WZ
WZ
WZ
WZ
WZ
Lb
Lb
Lb
Lb
Lb
On
On
On
"}
(23,1,1) = {"
TH
On
On
On
QR
WZ
WZ
WZ
WZ
WZ
WZ
WZ
WZ
Cv
WZ
WZ
Cv
WZ
WZ
Cv
vF
gQ
WZ
WZ
Cv
hx
vF
Lb
Lb
Lb
Lb
Lb
Lb
On
On
On
"}
(24,1,1) = {"
TH
On
On
QR
WZ
WZ
Cv
WZ
WZ
hx
WZ
WZ
WZ
WZ
WZ
WZ
WZ
WZ
WZ
WZ
WZ
hx
WZ
Lb
Lb
Lb
Lb
Lb
Lb
Lb
Lb
WZ
hx
On
On
TH
"}
(25,1,1) = {"
On
On
On
gQ
WZ
WZ
WZ
vF
WZ
WZ
WZ
WZ
Cv
WZ
hx
WZ
WZ
Cv
WZ
WZ
Uh
Lb
Lb
Lb
Lb
Lb
Lb
Lb
Lb
Lb
hx
WZ
WZ
On
On
On
"}
(26,1,1) = {"
On
On
WZ
WZ
WZ
WZ
gQ
WZ
WZ
Uh
WZ
WZ
WZ
WZ
WZ
WZ
WZ
hx
Lb
Lb
Lb
Lb
Lb
Lb
Lb
Lb
Lb
WZ
Cv
WZ
WZ
WZ
WZ
On
On
On
"}
(27,1,1) = {"
On
On
vF
WZ
WZ
Uh
sO
WZ
WZ
WZ
WZ
WZ
WZ
yX
gQ
vF
Lb
Lb
Lb
FK
Lb
Lb
Lb
Lb
Lb
Lb
WZ
WZ
WZ
gQ
WZ
WZ
Cv
gQ
On
On
"}
(28,1,1) = {"
On
On
On
WZ
WZ
WZ
WZ
hx
WZ
gQ
WZ
hx
WZ
FR
Lb
Lb
Lb
Lb
Lb
Lb
Lb
Lb
Lb
WZ
WZ
WZ
Uh
gQ
hx
WZ
WZ
WZ
pT
QR
On
On
"}
(29,1,1) = {"
TH
On
On
On
WZ
WZ
Cv
WZ
WZ
WZ
Lb
Lb
Lb
FR
Lb
Lb
Lb
Lb
WZ
WZ
Cv
WZ
WZ
WZ
Cv
WZ
WZ
WZ
WZ
WZ
Cv
gQ
WZ
WZ
On
On
"}
(30,1,1) = {"
TH
On
On
On
WZ
WZ
WZ
WZ
Cv
Lb
Lb
Lb
Lb
FR
Lb
Lb
Lb
WZ
WZ
WZ
WZ
WZ
Cv
WZ
WZ
WZ
WZ
WZ
EN
vF
WZ
WZ
WZ
Cv
On
On
"}
(31,1,1) = {"
On
On
On
On
WZ
WZ
vF
Lb
Lb
Lb
Lb
Lb
Lb
FR
Lb
Lb
WZ
WZ
Cv
WZ
WZ
WZ
jM
Rt
WZ
Cv
hx
WZ
WZ
WZ
gQ
WZ
WZ
On
On
On
"}
(32,1,1) = {"
On
On
On
On
hx
WZ
Lb
Lb
Lb
Lb
Lb
WZ
Cv
FR
Lb
WZ
Cv
WZ
WZ
WZ
hx
QR
QR
QR
WZ
WZ
WZ
WZ
WZ
Cv
WZ
WZ
hx
On
On
TH
"}
(33,1,1) = {"
TH
On
On
Lb
Lb
Lb
Lb
Lb
Lb
Lb
WZ
WZ
WZ
yX
gQ
WZ
vF
WZ
gQ
WZ
WZ
QR
nD
QR
jM
gQ
WZ
WZ
WZ
WZ
WZ
Uh
WZ
On
On
On
"}
(34,1,1) = {"
On
On
On
Lb
Lb
Lb
Lb
Lb
Lb
hx
gQ
WZ
WZ
WZ
pT
WZ
WZ
wR
WZ
WZ
WZ
Cv
Ne
QR
WZ
WZ
hx
WZ
gQ
WZ
WZ
WZ
WZ
On
On
On
"}
(35,1,1) = {"
On
On
On
On
Lb
Lb
Lb
Lb
WZ
WZ
hx
WZ
WZ
Cv
WZ
WZ
WZ
hx
WZ
gQ
WZ
WZ
Rt
WZ
gQ
WZ
Cv
WZ
WZ
WZ
gQ
WZ
WZ
On
On
On
"}
(36,1,1) = {"
TH
On
On
vF
gQ
WZ
Cv
gQ
WZ
vF
WZ
WZ
WZ
WZ
WZ
WZ
Cv
WZ
WZ
WZ
WZ
jM
WZ
WZ
Cv
WZ
WZ
WZ
WZ
Cv
vF
WZ
On
On
On
TH
"}
(37,1,1) = {"
On
On
QR
WZ
hx
WZ
WZ
hx
WZ
WZ
WZ
QR
WZ
hx
WZ
WZ
WZ
WZ
Cv
WZ
hx
Cv
WZ
WZ
WZ
hx
WZ
WZ
WZ
WZ
WZ
gQ
On
On
On
TH
"}
(38,1,1) = {"
On
On
WZ
WZ
WZ
WZ
tT
WZ
WZ
Cv
WZ
QR
QR
WZ
WZ
gQ
WZ
WZ
WZ
WZ
WZ
gQ
WZ
WZ
WZ
Cv
WZ
gQ
WZ
WZ
hx
WZ
On
On
On
TH
"}
(39,1,1) = {"
On
On
vF
WZ
WZ
Cv
WZ
WZ
WZ
WZ
WZ
Cv
WZ
hx
WZ
WZ
WZ
WZ
vF
WZ
Pr
WZ
WZ
QR
WZ
hx
WZ
gQ
WZ
WZ
Cv
WZ
WZ
On
On
On
"}
(40,1,1) = {"
On
On
On
Pr
WZ
WZ
WZ
WZ
Cv
WZ
hx
WZ
WZ
WZ
WZ
WZ
Cv
gQ
WZ
WZ
WZ
WZ
Cv
WZ
vF
WZ
Cv
WZ
WZ
hx
WZ
WZ
bj
On
On
On
"}
(41,1,1) = {"
TH
On
On
QR
hx
WZ
wR
WZ
WZ
Us
WZ
gQ
WZ
WZ
WZ
WZ
WZ
WZ
WZ
WZ
Cv
WZ
WZ
WZ
rd
WZ
WZ
WZ
WZ
Uh
WZ
WZ
Zb
On
On
On
"}
(42,1,1) = {"
TH
On
On
Cv
sO
hx
vF
WZ
hx
WZ
WZ
WZ
WZ
Uh
WZ
WZ
WZ
EN
hx
WZ
WZ
WZ
Uh
hx
WZ
WZ
fB
fB
dw
dw
fB
fB
bj
On
On
TH
"}
(43,1,1) = {"
TH
On
On
QR
WZ
WZ
WZ
WZ
WZ
Cv
hx
WZ
WZ
WZ
WZ
WZ
Cv
WZ
WZ
WZ
vF
WZ
WZ
WZ
WZ
WZ
fB
DZ
xF
kr
ZC
fB
bj
On
On
On
"}
(44,1,1) = {"
On
On
On
gQ
WZ
WZ
WZ
EN
WZ
WZ
WZ
WZ
WZ
kX
WZ
WZ
WZ
Pr
QR
WZ
WZ
WZ
WZ
Cv
WZ
WZ
fB
wh
xF
xF
OB
fB
bj
WZ
On
On
"}
(45,1,1) = {"
On
On
QR
WZ
hx
WZ
WZ
Cv
WZ
WZ
WZ
WZ
WZ
Cv
hx
WZ
hx
On
On
On
QR
WZ
WZ
WZ
WZ
WZ
yh
xF
vo
xF
uZ
fB
bj
QR
On
On
"}
(46,1,1) = {"
On
On
Cv
WZ
WZ
WZ
WZ
WZ
WZ
Cv
hx
WZ
WZ
WZ
WZ
QR
On
On
On
On
On
QR
WZ
WZ
Cv
WZ
fB
aH
xF
xF
Bq
fB
bj
On
On
On
"}
(47,1,1) = {"
On
On
On
vF
WZ
QR
WZ
Uh
WZ
WZ
WZ
WZ
hx
WZ
hx
On
On
On
TH
On
On
On
vF
WZ
WZ
WZ
fB
DZ
xF
xF
Bq
fB
bj
On
On
TH
"}
(48,1,1) = {"
TH
On
On
On
On
On
aK
bj
bj
WZ
Cv
WZ
WZ
QR
On
On
On
TH
TH
TH
On
On
On
On
WZ
WZ
fB
fB
dw
dw
fB
fB
bj
On
On
On
"}
(49,1,1) = {"
TH
TH
On
On
On
On
On
Zb
aK
WZ
WZ
WZ
On
On
On
On
TH
TH
TH
TH
TH
On
On
On
On
vF
WZ
WZ
WZ
WZ
WZ
WZ
bj
WZ
On
On
"}
(50,1,1) = {"
TH
TH
TH
TH
TH
On
On
On
bj
WZ
Cv
QR
On
On
TH
TH
TH
TH
TH
TH
TH
TH
TH
On
On
On
On
On
WZ
WZ
WZ
WZ
On
On
On
On
"}
(51,1,1) = {"
TH
TH
TH
TH
TH
TH
On
On
On
On
On
On
On
On
TH
TH
TH
TH
TH
TH
TH
TH
TH
TH
On
On
On
On
On
On
On
On
On
On
On
TH
"}
(52,1,1) = {"
TH
TH
TH
TH
TH
TH
On
On
On
On
On
On
On
TH
TH
TH
TH
TH
TH
TH
TH
TH
TH
TH
TH
TH
On
On
On
On
On
On
On
On
TH
TH
"}
