//MAP CONVERTED BY dmm2tgm.py THIS HEADER COMMENT PREVENTS RECONVERSION, DO NOT REMOVE
"a" = (
/turf/closed/wall/r_wall,
/area/station/maintenance/starboard/central)
"c" = (
/obj/effect/spawner/structure/window/reinforced,
/obj/structure/cable,
/turf/open/floor/plating,
/area/station/security/medical)
"d" = (
/obj/effect/turf_decal/trimline/dark_red/filled/line,
/obj/effect/turf_decal/trimline/dark_red/filled/corner{
	dir = 4
	},
/turf/open/floor/iron/white,
/area/station/security/medical)
"e" = (
/obj/effect/turf_decal/trimline/dark_red/filled/line{
	dir = 1
	},
/obj/machinery/atmospherics/components/unary/vent_scrubber/on/layer2{
	dir = 8
	},
/obj/structure/table/reinforced/rglass,
/obj/item/reagent_containers/cup/bottle/epinephrine{
	pixel_x = -8;
	pixel_y = 9
	},
/obj/item/reagent_containers/cup/bottle/formaldehyde{
	pixel_x = -3;
	pixel_y = 9
	},
/obj/item/reagent_containers/cup/bottle/multiver{
	pixel_x = 2;
	pixel_y = 9
	},
/obj/item/reagent_containers/syringe{
	pixel_x = -6;
	pixel_y = -2
	},
/turf/open/floor/iron/white,
/area/station/security/medical)
"f" = (
/obj/effect/turf_decal/siding/dark_red{
	dir = 1
	},
/obj/effect/turf_decal/trimline/dark_red/filled/corner{
	dir = 8
	},
/obj/effect/turf_decal/trimline/dark/corner{
	dir = 8
	},
/obj/machinery/stasis,
/obj/item/bedsheet/medical,
/obj/machinery/iv_drip,
/obj/item/radio/intercom/directional/east,
/turf/open/floor/iron/dark/smooth_corner{
	dir = 8
	},
/area/station/security/medical)
"k" = (
/turf/closed/wall/r_wall,
/area/station/security/medical)
"l" = (
/obj/effect/turf_decal/siding/dark_red{
	dir = 1
	},
/obj/structure/window/reinforced/spawner/directional/east,
/obj/machinery/airalarm/directional/south,
/obj/structure/closet/secure_closet/security_medic,
/turf/open/floor/iron/dark,
/area/station/security/medical)
"q" = (
/obj/effect/turf_decal/trimline/dark_red/filled/line{
	dir = 1
	},
/obj/machinery/atmospherics/components/unary/vent_pump/on/layer4{
	dir = 4
	},
/obj/machinery/computer/crew,
/turf/open/floor/iron/white,
/area/station/security/medical)
"s" = (
/obj/structure/window/reinforced/tinted/spawner/directional/east,
/obj/structure/window/reinforced/tinted/spawner/directional/west,
/obj/structure/window/reinforced/tinted/spawner/directional/south,
/obj/effect/turf_decal/siding/thinplating_new/dark/end,
/obj/structure/flora/bush/jungle,
/obj/structure/flora/bush/lavendergrass/style_random,
/obj/structure/hedge/opaque,
/obj/structure/window/reinforced/tinted/spawner/directional/north,
/turf/open/floor/grass,
/area/station/security/medical)
"t" = (
/obj/machinery/door/airlock/security/glass{
	name = "Break Room"
	},
/obj/effect/mapping_helpers/airlock/access/all/security/general,
/obj/machinery/door/firedoor,
/turf/open/floor/iron/dark,
/area/station/security/breakroom)
"w" = (
/obj/machinery/door/airlock/medical/glass{
	name = "Infirmary"
	},
/obj/machinery/door/firedoor,
/obj/structure/cable,
/obj/machinery/atmospherics/pipe/smart/manifold4w/supply/hidden/layer4,
/obj/machinery/atmospherics/pipe/smart/manifold4w/scrubbers/hidden/layer2,
/obj/structure/disposalpipe/segment,
/obj/effect/mapping_helpers/airlock/access/all/security/general,
/turf/open/floor/iron/dark,
/area/station/security/medical)
"x" = (
/obj/effect/turf_decal/trimline/dark_red/filled/line,
/obj/effect/turf_decal/trimline/dark_red/filled/corner{
	dir = 1
	},
/obj/structure/cable,
/obj/machinery/atmospherics/pipe/smart/manifold4w/supply/hidden/layer4,
/obj/machinery/atmospherics/pipe/smart/manifold4w/scrubbers/hidden/layer2,
/obj/structure/disposalpipe/segment{
	dir = 4
	},
/turf/open/floor/iron/white,
/area/station/security/medical)
"z" = (
/obj/structure/table/optable,
/obj/machinery/light/directional/south,
/obj/effect/turf_decal/trimline/dark_red/filled/line{
	dir = 1
	},
/obj/effect/turf_decal/trimline/dark/line{
	dir = 1
	},
/obj/machinery/vitals_reader/directional/south,
/turf/open/floor/iron/dark/smooth_edge,
/area/station/security/medical)
"A" = (
/obj/effect/turf_decal/trimline/dark_red/filled/corner{
	dir = 4
	},
/obj/effect/turf_decal/trimline/dark_red/filled/corner{
	dir = 1
	},
/obj/structure/cable,
/obj/machinery/atmospherics/pipe/smart/manifold4w/supply/hidden/layer4,
/obj/machinery/atmospherics/pipe/smart/manifold4w/scrubbers/hidden/layer2,
/obj/structure/disposalpipe/segment,
/turf/open/floor/iron/white,
/area/station/security/medical)
"B" = (
/obj/machinery/holopad,
/obj/effect/turf_decal/trimline/dark_red/filled/corner,
/obj/effect/turf_decal/trimline/dark_red/filled/corner{
	dir = 8
	},
/obj/structure/cable,
/obj/machinery/atmospherics/pipe/smart/manifold4w/supply/hidden/layer4,
/obj/machinery/atmospherics/pipe/smart/manifold4w/scrubbers/hidden/layer2,
/obj/structure/disposalpipe/segment{
	dir = 9
	},
/turf/open/floor/iron/white,
/area/station/security/medical)
"C" = (
/obj/machinery/light_switch/directional/west,
/obj/machinery/wall_healer/directional/north,
/obj/effect/turf_decal/trimline/dark_red/filled/line{
	dir = 9
	},
/obj/machinery/camera/autoname/directional/north,
/obj/machinery/computer/records/medical,
/turf/open/floor/iron/white,
/area/station/security/medical)
"E" = (
/turf/template_noop,
/area/template_noop)
"G" = (
/obj/structure/table/reinforced,
/obj/effect/spawner/surgery_tray/full,
/obj/effect/turf_decal/trimline/dark_red/filled/corner{
	dir = 1
	},
/obj/effect/turf_decal/trimline/dark/corner{
	dir = 1
	},
/obj/machinery/defibrillator_mount/directional/east,
/turf/open/floor/iron/dark/smooth_corner{
	dir = 1
	},
/area/station/security/medical)
"I" = (
/obj/effect/turf_decal/siding/dark_red{
	dir = 1
	},
/obj/effect/turf_decal/trimline/dark_red/filled/line,
/obj/effect/turf_decal/trimline/dark/line,
/turf/open/floor/iron/dark/smooth_edge{
	dir = 1
	},
/area/station/security/medical)
"K" = (
/obj/effect/turf_decal/siding/dark_red{
	dir = 1
	},
/obj/effect/turf_decal/trimline/dark_red/filled/corner,
/obj/effect/turf_decal/trimline/dark/corner,
/obj/structure/sink/directional/east,
/turf/open/floor/iron/dark/smooth_corner,
/area/station/security/medical)
"L" = (
/obj/machinery/firealarm/directional/east,
/obj/effect/turf_decal/trimline/dark_red/filled/line{
	dir = 5
	},
/obj/structure/table/reinforced/rglass,
/obj/item/paper_bin{
	pixel_x = 7;
	pixel_y = 7
	},
/obj/item/pen{
	pixel_x = 7;
	pixel_y = 9
	},
/obj/item/kirbyplants/organic/plant15{
	pixel_x = -16;
	pixel_y = 21
	},
/obj/item/reagent_containers/cup/glass/mug/nanotrasen{
	pixel_x = 4;
	pixel_y = 0
	},
/obj/item/reagent_containers/spray/cleaner{
	pixel_x = -5;
	pixel_y = 16
	},
/obj/item/folder/red{
	pixel_x = -9;
	pixel_y = 0
	},
/obj/item/folder/white{
	pixel_x = -14;
	pixel_y = 0
	},
/turf/open/floor/iron/white,
/area/station/security/medical)
"N" = (
/obj/effect/turf_decal/trimline/dark_red/filled/line,
/obj/structure/cable,
/obj/machinery/atmospherics/pipe/smart/manifold4w/supply/hidden/layer4,
/obj/machinery/atmospherics/pipe/smart/manifold4w/scrubbers/hidden/layer2,
/obj/structure/disposalpipe/segment{
	dir = 4
	},
/obj/effect/landmark/start/security_medic,
/turf/open/floor/iron/white,
/area/station/security/medical)
"O" = (
/obj/effect/turf_decal/trimline/dark_red/filled/line,
/obj/effect/landmark/start/security_medic,
/obj/structure/chair/office{
	dir = 1
	},
/turf/open/floor/iron/white,
/area/station/security/medical)
"P" = (
/obj/effect/turf_decal/siding/dark_red{
	dir = 1
	},
/obj/structure/extinguisher_cabinet/directional/west,
/obj/machinery/power/apc/auto_name/directional/south,
/obj/structure/cable,
/obj/machinery/camera/autoname/directional/west,
/obj/structure/rack/shelf,
/obj/item/storage/medkit/regular{
	pixel_x = 0;
	pixel_y = -3
	},
/obj/item/storage/box/bodybags,
/obj/item/healthanalyzer{
	pixel_x = 0;
	pixel_y = 6
	},
/turf/open/floor/iron/dark,
/area/station/security/medical)
"Q" = (
/obj/machinery/door/airlock/maintenance{
	name = "Brig Infirmary Maintenance"
	},
/obj/structure/cable,
/obj/effect/mapping_helpers/airlock/access/all/security/general,
/obj/machinery/atmospherics/pipe/smart/manifold4w/supply/hidden/layer4,
/obj/machinery/atmospherics/pipe/smart/manifold4w/scrubbers/hidden/layer2,
/obj/structure/disposalpipe/segment{
	dir = 4
	},
/turf/open/floor/plating,
/area/station/maintenance/starboard/central)
"S" = (
/obj/structure/sign/departments/medbay/alt,
/turf/closed/wall/r_wall,
/area/station/security/medical)
"T" = (
/turf/closed/wall/r_wall,
/area/station/security/breakroom)
"V" = (
/obj/machinery/computer/operating{
	dir = 1
	},
/obj/effect/turf_decal/trimline/dark_red/filled/corner{
	dir = 4
	},
/obj/effect/turf_decal/trimline/dark/corner{
	dir = 4
	},
/turf/open/floor/iron/dark/smooth_corner{
	dir = 4
	},
/area/station/security/medical)

(1,1,1) = {"
a
a
Q
a
a
E
"}
(2,1,1) = {"
k
C
x
P
a
E
"}
(3,1,1) = {"
c
q
N
l
a
a
"}
(4,1,1) = {"
w
A
B
K
V
s
"}
(5,1,1) = {"
c
e
O
I
z
k
"}
(6,1,1) = {"
S
L
d
f
G
s
"}
(7,1,1) = {"
T
T
t
T
T
T
"}
