//MAP CONVERTED BY dmm2tgm.py THIS HEADER COMMENT PREVENTS RECONVERSION, DO NOT REMOVE
"ag" = (
/obj/structure/hedge,
/obj/structure/sign/directions/engineering/directional/south{
	pixel_y = -40
	},
/obj/structure/sign/directions/dorms/directional/south{
	pixel_y = -24;
	dir = 8
	},
/obj/structure/sign/directions/evac/directional/south{
	dir = 8
	},
/obj/structure/cable,
/obj/machinery/atmospherics/pipe/smart/manifold4w/supply/hidden/layer4,
/obj/machinery/atmospherics/pipe/smart/manifold4w/scrubbers/hidden/layer2,
/obj/effect/turf_decal/tile/neutral{
	dir = 8
	},
/turf/open/floor/iron,
/area/station/hallway/primary/central)
"as" = (
/obj/effect/turf_decal/siding/wood{
	dir = 8
	},
/obj/structure/table/wood,
/obj/item/paper_bin{
	pixel_y = 5;
	pixel_x = -4
	},
/obj/item/pen{
	pixel_y = 5;
	pixel_x = -4
	},
/obj/item/stamp/granted{
	pixel_x = 8;
	pixel_y = 8
	},
/obj/item/stamp/denied{
	pixel_x = 8;
	pixel_y = 2
	},
/obj/structure/window/reinforced/spawner/directional/west,
/turf/open/floor/wood/large,
/area/station/command/heads_quarters/nt_rep)
"ax" = (
/obj/structure/cable,
/obj/machinery/atmospherics/pipe/smart/manifold4w/scrubbers/hidden/layer2,
/obj/machinery/atmospherics/pipe/smart/manifold4w/supply/hidden/layer4,
/turf/open/floor/carpet/blue,
/area/station/command/heads_quarters/blueshield)
"aB" = (
/obj/machinery/status_display/ai/directional/south,
/obj/structure/closet/secure_closet/nanotrasen_crew_trainer,
/obj/item/storage/lunchbox/nanotrasen,
/obj/effect/turf_decal/siding/wood{
	dir = 10
	},
/turf/open/floor/wood/large,
/area/station/command/heads_quarters/nt_rep)
"aP" = (
/obj/machinery/door/airlock/maintenance,
/obj/effect/mapping_helpers/airlock/access/all/cent_com/nanotrasenstaff,
/turf/open/floor/iron/dark/textured_large,
/area/station/command/heads_quarters/nt_rep)
"aW" = (
/obj/effect/turf_decal/siding/wood{
	dir = 5
	},
/obj/structure/hedge,
/turf/open/floor/wood/large,
/area/station/command/heads_quarters/nt_rep)
"bR" = (
/obj/machinery/atmospherics/pipe/smart/manifold4w/supply/hidden/layer4,
/obj/machinery/atmospherics/pipe/smart/manifold4w/scrubbers/hidden/layer2,
/obj/effect/turf_decal/siding/wood/corner{
	dir = 4
	},
/turf/open/floor/wood/large,
/area/station/command/heads_quarters/nt_rep)
"bX" = (
/obj/effect/turf_decal/tile/blue/diagonal_centre,
/obj/structure/cable,
/obj/machinery/atmospherics/pipe/smart/manifold4w/scrubbers/hidden/layer2,
/obj/machinery/atmospherics/pipe/smart/manifold4w/supply/hidden/layer4,
/obj/effect/landmark/start/blueshield,
/turf/open/floor/iron/dark/diagonal,
/area/station/command/heads_quarters/blueshield)
"cA" = (
/obj/structure/cable,
/obj/machinery/atmospherics/pipe/smart/manifold4w/supply/hidden/layer4,
/obj/machinery/atmospherics/pipe/smart/manifold4w/scrubbers/hidden/layer2,
/obj/effect/turf_decal/trimline/blue/filled/corner,
/obj/effect/turf_decal/trimline/dark/corner,
/turf/open/floor/iron,
/area/station/hallway/primary/central)
"cF" = (
/obj/structure/cable,
/obj/machinery/atmospherics/pipe/smart/manifold4w/supply/hidden/layer4,
/obj/machinery/atmospherics/pipe/smart/manifold4w/scrubbers/hidden/layer2,
/obj/structure/disposalpipe/segment{
	dir = 4
	},
/obj/effect/turf_decal/tile/neutral{
	dir = 8
	},
/turf/open/floor/iron,
/area/station/hallway/primary/central)
"cZ" = (
/obj/machinery/atmospherics/pipe/smart/manifold4w/supply/hidden/layer4,
/obj/machinery/atmospherics/pipe/smart/manifold4w/scrubbers/hidden/layer2,
/obj/structure/cable,
/obj/effect/turf_decal/siding/wood{
	dir = 1
	},
/obj/effect/turf_decal/siding/wood/corner,
/turf/open/floor/wood/large,
/area/station/command/heads_quarters/nt_rep)
"dH" = (
/obj/machinery/light/warm/directional/south,
/obj/effect/turf_decal/siding/wood{
	dir = 6
	},
/obj/structure/sign/calendar/directional/south,
/obj/structure/filingcabinet/medical{
	pixel_x = -10;
	icon_state = "employmentcabinet";
	name = "medical records filing cabinet"
	},
/obj/structure/filingcabinet/employment{
	name = "employment forms filing cabinet"
	},
/obj/structure/filingcabinet/security{
	pixel_x = 10;
	icon_state = "employmentcabinet";
	name = "security records filing cabinet"
	},
/turf/open/floor/wood/large,
/area/station/command/heads_quarters/nt_rep)
"dK" = (
/obj/machinery/atmospherics/pipe/smart/manifold4w/supply/hidden/layer4,
/obj/effect/turf_decal/siding/wood/corner{
	dir = 4
	},
/obj/effect/turf_decal/siding/wood/corner{
	dir = 8
	},
/turf/open/floor/wood/large,
/area/station/command/heads_quarters/nt_rep)
"ei" = (
/obj/structure/table/reinforced/titaniumglass,
/obj/item/paper_bin{
	pixel_y = 5;
	pixel_x = -4
	},
/obj/item/pen/fountain/nanotrasen{
	pixel_y = 5;
	pixel_x = -4
	},
/obj/item/stamp/granted{
	pixel_x = 8;
	pixel_y = 8
	},
/obj/item/stamp/denied{
	pixel_x = 8;
	pixel_y = 3
	},
/obj/machinery/camera/directional/south{
	c_tag = "Blueshield's Office"
	},
/obj/machinery/button/door/directional/south{
	name = "Privacy Shutters Control";
	id = "blueshield_priv";
	req_access = list("cent_officer")
	},
/turf/open/floor/carpet/blue,
/area/station/command/heads_quarters/blueshield)
"eE" = (
/obj/structure/chair/sofa/right/brown{
	dir = 4;
	color = "#462f1c"
	},
/obj/machinery/airalarm/directional/west,
/obj/item/radio/intercom/directional/south,
/turf/open/floor/carpet/cyan,
/area/station/command/heads_quarters/nt_rep)
"fh" = (
/obj/machinery/atmospherics/pipe/smart/manifold4w/supply/hidden/layer4,
/obj/machinery/atmospherics/pipe/smart/manifold4w/scrubbers/hidden/layer2,
/obj/structure/cable,
/obj/machinery/light_switch/directional/east,
/obj/effect/turf_decal/siding/wood/end{
	dir = 4
	},
/turf/open/floor/wood/large,
/area/station/command/heads_quarters/nt_rep)
"fs" = (
/obj/effect/turf_decal/siding/thinplating_new/dark{
	dir = 8
	},
/obj/structure/closet/secure_closet/blueshield,
/obj/machinery/power/apc/auto_name/directional/east,
/obj/structure/cable,
/turf/open/floor/iron/dark/small,
/area/station/command/heads_quarters/blueshield)
"fE" = (
/obj/machinery/computer/crew{
	dir = 4
	},
/obj/machinery/newscaster/directional/west,
/turf/open/floor/carpet/blue,
/area/station/command/heads_quarters/blueshield)
"gj" = (
/obj/machinery/atmospherics/pipe/smart/manifold4w/scrubbers/hidden/layer2,
/obj/effect/turf_decal/siding/wood{
	dir = 1
	},
/obj/structure/cable,
/obj/machinery/atmospherics/pipe/smart/manifold4w/supply/hidden/layer4,
/obj/structure/chair/sofa/right/brown{
	dir = 8;
	color = "#3d3c38"
	},
/obj/structure/extinguisher_cabinet/directional/east,
/turf/open/floor/wood/parquet,
/area/station/command/heads_quarters/blueshield)
"gW" = (
/obj/effect/turf_decal/siding/wood/end{
	dir = 4
	},
/obj/machinery/status_display/evac/directional/north,
/obj/structure/aquarium/prefilled,
/obj/item/reagent_containers/cup/fish_feed{
	pixel_y = 17;
	pixel_x = -3
	},
/turf/open/floor/wood/large,
/area/station/command/heads_quarters/nt_rep)
"hC" = (
/obj/machinery/atmospherics/pipe/smart/manifold4w/scrubbers/hidden/layer2,
/obj/machinery/atmospherics/pipe/smart/manifold4w/supply/hidden/layer4,
/obj/structure/cable,
/obj/effect/turf_decal/tile/neutral{
	dir = 8
	},
/turf/open/floor/iron,
/area/station/hallway/primary/central)
"hI" = (
/obj/effect/mapping_helpers/turn_off_lights_with_lightswitch,
/turf/open/floor/carpet/blue,
/area/station/command/heads_quarters/blueshield)
"jM" = (
/obj/machinery/atmospherics/pipe/smart/manifold4w/scrubbers/hidden/layer2,
/obj/machinery/atmospherics/pipe/smart/manifold4w/supply/hidden/layer4,
/obj/structure/cable,
/turf/open/floor/iron,
/area/station/hallway/primary/central)
"jX" = (
/obj/effect/turf_decal/siding/wood{
	dir = 10
	},
/obj/structure/grandfatherclock,
/obj/structure/sign/poster/official/nanotrasen_logo/directional/south,
/turf/open/floor/wood/parquet,
/area/station/command/heads_quarters/blueshield)
"kB" = (
/obj/effect/turf_decal/siding/wood,
/obj/machinery/atmospherics/components/unary/vent_scrubber/on/layer2{
	dir = 1
	},
/obj/structure/aquarium/prefilled,
/obj/item/reagent_containers/cup/fish_feed{
	pixel_y = 17;
	pixel_x = -3
	},
/turf/open/floor/wood/parquet,
/area/station/command/heads_quarters/blueshield)
"kS" = (
/obj/machinery/door/airlock/highsecurity{
	name = "Blueshield's Armory"
	},
/obj/machinery/door/firedoor,
/obj/structure/cable,
/obj/machinery/atmospherics/pipe/smart/manifold4w/scrubbers/hidden/layer2,
/obj/machinery/atmospherics/pipe/smart/manifold4w/supply/hidden/layer4,
/obj/effect/mapping_helpers/airlock/access/all/cent_com/blueshield,
/turf/open/floor/iron/dark/textured_large,
/area/station/command/heads_quarters/blueshield)
"lD" = (
/obj/structure/table/reinforced/titaniumglass,
/obj/machinery/recharger{
	pixel_y = 3;
	pixel_x = -6
	},
/obj/item/flashlight/lamp/green{
	pixel_y = 14;
	pixel_x = 5
	},
/obj/item/phone{
	pixel_x = 8;
	pixel_y = -1
	},
/obj/structure/noticeboard/directional/south,
/turf/open/floor/carpet/blue,
/area/station/command/heads_quarters/blueshield)
"lY" = (
/obj/effect/turf_decal/siding/wood{
	dir = 8
	},
/obj/effect/turf_decal/siding/wood/corner,
/obj/machinery/newscaster/directional/west,
/obj/effect/spawner/random/ntc_pet,
/obj/structure/bed/dogbed/luxury,
/turf/open/floor/wood/large,
/area/station/command/heads_quarters/nt_rep)
"mT" = (
/obj/structure/table/reinforced/titaniumglass,
/obj/item/clipboard{
	pixel_y = 3;
	pixel_x = -5
	},
/obj/item/folder/nanotrasen{
	pixel_y = 2;
	pixel_x = -4
	},
/obj/item/reagent_containers/cup/glass/mug/nanotrasen{
	pixel_y = 11;
	pixel_x = 11
	},
/obj/item/sign/flag/nanotrasen{
	pixel_x = 5
	},
/obj/structure/window/reinforced/spawner/directional/south,
/turf/open/floor/carpet/executive,
/area/station/command/heads_quarters/nt_rep)
"mX" = (
/obj/effect/turf_decal/siding/thinplating_new/dark{
	dir = 8
	},
/obj/structure/rack/shelf,
/obj/item/storage/toolbox/ammobox/wt550m9,
/obj/machinery/airalarm/directional/east,
/turf/open/floor/iron/dark/small,
/area/station/command/heads_quarters/blueshield)
"nO" = (
/obj/machinery/atmospherics/components/unary/vent_scrubber/on/layer2{
	dir = 4
	},
/turf/open/floor/wood/large,
/area/station/command/heads_quarters/nt_rep)
"pF" = (
/obj/structure/cable,
/obj/machinery/atmospherics/pipe/smart/manifold4w/scrubbers/hidden/layer2,
/obj/machinery/atmospherics/pipe/smart/manifold4w/supply/hidden/layer4,
/obj/machinery/light_switch/directional/east,
/obj/effect/turf_decal/siding/wood/end{
	dir = 4
	},
/turf/open/floor/wood/parquet,
/area/station/command/heads_quarters/blueshield)
"pV" = (
/obj/machinery/atmospherics/pipe/smart/manifold4w/supply/hidden/layer4,
/obj/effect/turf_decal/siding/wood{
	dir = 1
	},
/turf/open/floor/wood/large,
/area/station/command/heads_quarters/nt_rep)
"qi" = (
/obj/effect/spawner/structure/window/reinforced,
/obj/machinery/door/poddoor/shutters/preopen{
	id = "blueshield_priv";
	name = "Privacy Shutters";
	dir = 1
	},
/obj/structure/cable,
/turf/open/floor/plating,
/area/station/command/heads_quarters/blueshield)
"qG" = (
/obj/machinery/computer/security{
	dir = 4
	},
/obj/structure/sign/calendar/directional/west,
/obj/item/radio/intercom/directional/south,
/turf/open/floor/carpet/blue,
/area/station/command/heads_quarters/blueshield)
"qI" = (
/obj/effect/turf_decal/trimline/blue/filled/line,
/obj/effect/turf_decal/trimline/dark/line,
/obj/structure/cable,
/obj/machinery/atmospherics/pipe/smart/manifold4w/supply/hidden/layer4,
/obj/machinery/atmospherics/pipe/smart/manifold4w/scrubbers/hidden/layer2,
/turf/open/floor/iron,
/area/station/hallway/primary/central)
"qW" = (
/obj/structure/chair/comfy/brown,
/obj/effect/landmark/start/nanotrasen_consultant,
/turf/open/floor/carpet/executive,
/area/station/command/heads_quarters/nt_rep)
"rl" = (
/obj/structure/safe/floor/ntc,
/obj/item/folder/ntc_documents,
/obj/item/reagent_containers/cup/glass/flask/gold,
/obj/item/reagent_containers/applicator/pill/cyanide,
/obj/item/photo{
	name = "department group photo";
	desc = "A recent photo of all the Internal Affairs staff, the Affairs Director, Assistant Director, and all the Executive Officers, and Crew Trainers. You almost miss the good days.."
	},
/obj/item/reagent_containers/cup/glass/bottle/rum/aged,
/obj/item/gun/energy/pulse/pistol/m1911/fake_ntc,
/obj/item/toy/figure/dsquad,
/obj/item/coin/adamantine,
/obj/item/encryptionkey/headset_cent,
/turf/open/floor/carpet/executive,
/area/station/command/heads_quarters/nt_rep)
"sp" = (
/obj/effect/turf_decal/tile/neutral{
	dir = 8
	},
/obj/structure/cable,
/obj/machinery/atmospherics/pipe/smart/manifold4w/supply/hidden/layer4,
/obj/machinery/atmospherics/pipe/smart/manifold4w/scrubbers/hidden/layer2,
/obj/structure/disposalpipe/segment,
/turf/open/floor/iron,
/area/station/hallway/primary/central)
"te" = (
/obj/structure/rack,
/obj/effect/spawner/random/clothing/costume,
/turf/open/floor/plating,
/area/station/maintenance/port/aft)
"ti" = (
/obj/effect/mapping_helpers/turn_off_lights_with_lightswitch,
/obj/effect/turf_decal/siding/wood{
	dir = 1
	},
/turf/open/floor/wood/large,
/area/station/command/heads_quarters/nt_rep)
"ty" = (
/obj/machinery/modular_computer/preset/command{
	dir = 4
	},
/obj/machinery/status_display/evac/directional/west,
/obj/machinery/light/directional/west,
/turf/open/floor/carpet/blue,
/area/station/command/heads_quarters/blueshield)
"tE" = (
/obj/effect/turf_decal/tile/neutral{
	dir = 8
	},
/obj/structure/cable,
/obj/machinery/atmospherics/pipe/smart/manifold4w/supply/hidden/layer4,
/obj/machinery/atmospherics/pipe/smart/manifold4w/scrubbers/hidden/layer2,
/obj/structure/disposalpipe/segment{
	dir = 5
	},
/turf/open/floor/iron,
/area/station/hallway/primary/central)
"tV" = (
/obj/effect/turf_decal/siding/wood{
	dir = 9
	},
/turf/open/floor/wood/large,
/area/station/command/heads_quarters/nt_rep)
"vy" = (
/obj/structure/cable,
/obj/machinery/atmospherics/pipe/smart/manifold4w/supply/hidden/layer4,
/obj/machinery/atmospherics/pipe/smart/manifold4w/scrubbers/hidden/layer2,
/obj/structure/disposalpipe/segment,
/obj/effect/turf_decal/tile/neutral{
	dir = 8
	},
/turf/open/floor/iron,
/area/station/hallway/primary/central)
"vU" = (
/obj/structure/table/wood,
/obj/item/taperecorder{
	pixel_y = 2;
	pixel_x = -5
	},
/obj/item/tape{
	pixel_x = 4
	},
/obj/machinery/vending/boozeomat{
	pixel_y = -32;
	density = 0;
	req_access = list("cent_general")
	},
/obj/machinery/light/directional/south,
/turf/open/floor/carpet/cyan,
/area/station/command/heads_quarters/nt_rep)
"wV" = (
/obj/structure/cable,
/obj/machinery/atmospherics/pipe/smart/manifold4w/supply/hidden/layer4,
/obj/machinery/atmospherics/pipe/smart/manifold4w/scrubbers/hidden/layer2,
/obj/machinery/camera/autoname/directional/south,
/obj/machinery/firealarm/directional/south,
/obj/effect/turf_decal/trimline/blue/filled/corner{
	dir = 8
	},
/obj/effect/turf_decal/trimline/dark/corner{
	dir = 8
	},
/turf/open/floor/iron,
/area/station/hallway/primary/central)
"wZ" = (
/obj/structure/chair/sofa/right/brown{
	dir = 8;
	color = "#462f1c"
	},
/turf/open/floor/carpet/cyan,
/area/station/command/heads_quarters/nt_rep)
"yi" = (
/obj/effect/turf_decal/siding/wood{
	dir = 8
	},
/turf/open/floor/wood/parquet,
/area/station/command/heads_quarters/blueshield)
"zF" = (
/obj/structure/chair/sofa/left/brown{
	dir = 8;
	color = "#462f1c"
	},
/obj/structure/sign/poster/official/enlist/directional/south,
/obj/machinery/camera/autoname/directional/south,
/turf/open/floor/carpet/cyan,
/area/station/command/heads_quarters/nt_rep)
"zJ" = (
/obj/structure/extinguisher_cabinet/directional/south,
/obj/machinery/power/apc/auto_name/directional/east,
/obj/structure/cable,
/obj/structure/hedge,
/obj/effect/turf_decal/siding/wood{
	dir = 6
	},
/turf/open/floor/wood/large,
/area/station/command/heads_quarters/nt_rep)
"AH" = (
/obj/effect/turf_decal/siding/wood,
/obj/machinery/holopad,
/obj/machinery/atmospherics/pipe/smart/manifold4w/supply/hidden/layer4,
/obj/effect/landmark/event_spawn,
/turf/open/floor/wood/large,
/area/station/command/heads_quarters/nt_rep)
"Bj" = (
/obj/machinery/firealarm/directional/west,
/obj/effect/turf_decal/siding/wood/end{
	dir = 8
	},
/obj/structure/hedge,
/turf/open/floor/wood/parquet,
/area/station/command/heads_quarters/blueshield)
"BD" = (
/obj/machinery/modular_computer/preset/command{
	dir = 8
	},
/turf/open/floor/carpet/executive,
/area/station/command/heads_quarters/nt_rep)
"DX" = (
/turf/closed/wall/r_wall,
/area/station/command/heads_quarters/nt_rep)
"Ea" = (
/obj/structure/cable,
/obj/machinery/atmospherics/pipe/smart/manifold4w/scrubbers/hidden/layer2,
/obj/machinery/atmospherics/pipe/smart/manifold4w/supply/hidden/layer4,
/turf/open/floor/wood/parquet,
/area/station/command/heads_quarters/blueshield)
"Ef" = (
/obj/structure/table/wood,
/obj/item/folder/blue{
	pixel_x = -7;
	pixel_y = 3
	},
/obj/item/folder/yellow{
	pixel_x = 6;
	pixel_y = 3
	},
/obj/item/folder/nanotrasen,
/turf/open/floor/carpet/cyan,
/area/station/command/heads_quarters/nt_rep)
"FB" = (
/obj/machinery/door/firedoor,
/obj/structure/cable,
/obj/machinery/atmospherics/pipe/smart/manifold4w/scrubbers/hidden/layer2,
/obj/machinery/atmospherics/pipe/smart/manifold4w/supply/hidden/layer4,
/obj/machinery/door/airlock/corporate{
	name = "Nanotrasen Internal Affairs Office"
	},
/obj/effect/landmark/navigate_destination/autoname,
/obj/effect/mapping_helpers/airlock/unres,
/obj/effect/mapping_helpers/airlock/access/all/cent_com/nanotrasenstaff,
/turf/open/floor/iron/dark/textured_large,
/area/station/command/heads_quarters/nt_rep)
"FE" = (
/obj/effect/turf_decal/siding/wood/corner,
/turf/open/floor/wood/large,
/area/station/command/heads_quarters/nt_rep)
"GJ" = (
/obj/machinery/atmospherics/pipe/smart/manifold4w/supply/hidden/layer4,
/obj/effect/turf_decal/siding/wood,
/obj/effect/landmark/start/nanotrasen_crew_trainer,
/turf/open/floor/wood/large,
/area/station/command/heads_quarters/nt_rep)
"HG" = (
/obj/structure/chair/comfy/black{
	dir = 8
	},
/obj/effect/landmark/start/blueshield,
/turf/open/floor/carpet/blue,
/area/station/command/heads_quarters/blueshield)
"IO" = (
/obj/machinery/atmospherics/pipe/smart/manifold4w/scrubbers/hidden/layer2,
/obj/effect/turf_decal/siding/wood{
	dir = 9
	},
/obj/structure/cable,
/obj/machinery/atmospherics/pipe/smart/manifold4w/supply/hidden/layer4,
/turf/open/floor/wood/parquet,
/area/station/command/heads_quarters/blueshield)
"Ke" = (
/obj/effect/spawner/structure/window/reinforced,
/obj/structure/cable,
/obj/structure/curtain/cloth/fancy/mechanical{
	icon_state = "bathroom-open";
	icon_type = "bathroom";
	id = "ntc_privatecurtains";
	name = "expensive curtain";
	color = "#2E7DA5";
	desc = "An expensive set of excellent cloth drapes."
	},
/turf/open/floor/plating,
/area/station/command/heads_quarters/nt_rep)
"Ks" = (
/obj/effect/turf_decal/tile/blue/diagonal_centre,
/obj/structure/cable,
/obj/machinery/atmospherics/pipe/smart/manifold4w/supply/hidden/layer4,
/turf/open/floor/iron/dark/diagonal,
/area/station/command/heads_quarters/blueshield)
"Ll" = (
/obj/effect/turf_decal/siding/wood,
/obj/machinery/atmospherics/pipe/smart/manifold4w/supply/hidden/layer4,
/turf/open/floor/wood/large,
/area/station/command/heads_quarters/nt_rep)
"Lo" = (
/obj/effect/turf_decal/siding/thinplating_new/dark{
	dir = 8
	},
/obj/structure/rack/shelf,
/obj/item/storage/medkit/brute,
/obj/item/storage/medkit/fire{
	pixel_y = 4
	},
/obj/machinery/status_display/evac/directional/east,
/obj/machinery/light/red/directional/east,
/turf/open/floor/iron/dark/small,
/area/station/command/heads_quarters/blueshield)
"LC" = (
/obj/effect/turf_decal/siding/wood{
	dir = 8
	},
/obj/machinery/holopad,
/obj/effect/landmark/event_spawn,
/turf/open/floor/wood/parquet,
/area/station/command/heads_quarters/blueshield)
"Mk" = (
/obj/structure/sign/calendar/directional/west,
/obj/machinery/light/directional/west,
/turf/open/floor/carpet/executive,
/area/station/command/heads_quarters/nt_rep)
"Nq" = (
/obj/structure/hedge,
/obj/effect/turf_decal/siding/wood/end,
/turf/open/floor/wood/large,
/area/station/command/heads_quarters/nt_rep)
"NB" = (
/obj/effect/turf_decal/tile/blue/diagonal_centre,
/obj/machinery/atmospherics/components/unary/vent_pump/on/layer4,
/turf/open/floor/iron/dark/diagonal,
/area/station/command/heads_quarters/blueshield)
"NM" = (
/obj/machinery/door/firedoor,
/obj/structure/cable,
/obj/machinery/atmospherics/pipe/smart/manifold4w/scrubbers/hidden/layer2,
/obj/machinery/atmospherics/pipe/smart/manifold4w/supply/hidden/layer4,
/obj/machinery/door/airlock/corporate{
	name = "Blueshield's Office"
	},
/obj/effect/landmark/navigate_destination/autoname,
/obj/effect/mapping_helpers/airlock/access/all/cent_com/blueshield,
/turf/open/floor/iron/dark/textured_large,
/area/station/command/heads_quarters/blueshield)
"NR" = (
/turf/closed/wall/r_wall,
/area/station/command/heads_quarters/blueshield)
"Oo" = (
/obj/structure/cable,
/obj/machinery/atmospherics/pipe/smart/manifold4w/supply/hidden/layer4,
/obj/machinery/atmospherics/pipe/smart/manifold4w/scrubbers/hidden/layer2,
/turf/open/floor/iron,
/area/station/hallway/primary/central)
"Or" = (
/obj/structure/sign/directions/dorms/directional/west{
	pixel_y = 8;
	pixel_x = 0
	},
/obj/structure/sign/directions/evac/directional/west{
	pixel_x = 0
	},
/obj/structure/sign/directions/engineering/directional/west{
	pixel_y = -8;
	dir = 2;
	pixel_x = 0
	},
/turf/closed/wall/r_wall,
/area/station/command/heads_quarters/nt_rep)
"OA" = (
/obj/structure/chair/sofa/left/brown{
	dir = 4;
	color = "#462f1c"
	},
/turf/open/floor/carpet/cyan,
/area/station/command/heads_quarters/nt_rep)
"OR" = (
/obj/machinery/atmospherics/pipe/smart/manifold4w/supply/hidden/layer4,
/obj/effect/turf_decal/siding/wood{
	dir = 5
	},
/obj/machinery/photocopier/prebuilt,
/obj/item/toy/plush/skyrat/ian/lisa{
	pixel_y = 11
	},
/turf/open/floor/wood/large,
/area/station/command/heads_quarters/nt_rep)
"PQ" = (
/obj/effect/turf_decal/siding/thinplating_new/dark{
	dir = 8
	},
/obj/structure/closet/secure_closet/tac{
	req_access = list("cent_officer")
	},
/obj/item/clothing/suit/armor/riot,
/obj/item/clothing/head/helmet/toggleable/riot,
/obj/machinery/status_display/ai/directional/east,
/obj/structure/sign/poster/official/nanotrasen_logo/directional/north,
/obj/machinery/light/red/directional/east,
/turf/open/floor/iron/dark/small,
/area/station/command/heads_quarters/blueshield)
"QS" = (
/obj/machinery/fax{
	fax_name = "Nanotrasen Consultant's Office";
	name = "Nanotrasen Consultant's Fax Machine"
	},
/obj/effect/turf_decal/siding/wood{
	dir = 1
	},
/obj/effect/turf_decal/siding/wood,
/obj/machinery/keycard_auth/wall_mounted/directional/north,
/obj/structure/table/wood/fancy/cyan,
/turf/open/floor/wood/large,
/area/station/command/heads_quarters/nt_rep)
"Ru" = (
/obj/effect/turf_decal/siding/wood/end{
	dir = 8
	},
/obj/structure/sign/clock/directional/west,
/obj/machinery/status_display/ai/directional/north,
/obj/item/reagent_containers/cup/glass/trophy/gold_cup{
	pixel_y = 14
	},
/obj/structure/table/wood/fancy/cyan,
/turf/open/floor/wood/large,
/area/station/command/heads_quarters/nt_rep)
"SP" = (
/obj/effect/turf_decal/siding/wood{
	dir = 1
	},
/obj/effect/turf_decal/siding/wood,
/obj/structure/noticeboard/directional/north,
/obj/machinery/coffeemaker/impressa{
	pixel_y = 8;
	pixel_x = 9
	},
/obj/item/storage/fancy/coffee_condi_display{
	pixel_x = -13;
	pixel_y = 12
	},
/obj/item/reagent_containers/cup/glass/mug/nanotrasen{
	pixel_x = -15;
	pixel_y = 3
	},
/obj/item/reagent_containers/cup/glass/mug/nanotrasen{
	pixel_x = -6
	},
/obj/structure/table/wood/fancy/cyan,
/turf/open/floor/wood/large,
/area/station/command/heads_quarters/nt_rep)
"Th" = (
/obj/machinery/door/window/brigdoor/left/directional/south{
	name = "Nanotrasen Consultant's Desk";
	req_access = list("cent_captain")
	},
/obj/structure/sign/flag/nanotrasen/directional/west,
/turf/open/floor/carpet/executive,
/area/station/command/heads_quarters/nt_rep)
"UW" = (
/obj/machinery/computer/station_goal{
	dir = 8
	},
/turf/open/floor/carpet/executive,
/area/station/command/heads_quarters/nt_rep)
"Vx" = (
/obj/structure/cable,
/obj/machinery/atmospherics/pipe/smart/manifold4w/supply/hidden/layer4,
/obj/machinery/atmospherics/pipe/smart/manifold4w/scrubbers/hidden/layer2,
/obj/effect/turf_decal/trimline/blue/filled/line,
/obj/effect/turf_decal/trimline/dark/line,
/turf/open/floor/iron,
/area/station/hallway/primary/central)
"Wq" = (
/turf/open/floor/carpet/executive,
/area/station/command/heads_quarters/nt_rep)
"WE" = (
/obj/machinery/atmospherics/pipe/smart/manifold4w/scrubbers/hidden/layer2,
/obj/structure/cable,
/obj/machinery/atmospherics/pipe/smart/manifold4w/supply/hidden/layer4,
/obj/machinery/airalarm/directional/east,
/obj/structure/chair/sofa/left/brown{
	dir = 8;
	color = "#3d3c38"
	},
/obj/machinery/light/directional/east,
/turf/open/floor/wood/parquet,
/area/station/command/heads_quarters/blueshield)
"Xs" = (
/obj/effect/turf_decal/siding/wood/corner{
	dir = 8
	},
/obj/structure/chair/office{
	dir = 8
	},
/obj/effect/landmark/start/nanotrasen_crew_trainer,
/turf/open/floor/wood/large,
/area/station/command/heads_quarters/nt_rep)
"XN" = (
/obj/structure/table/reinforced/titaniumglass,
/obj/item/flashlight/lamp/green{
	pixel_y = 13;
	pixel_x = -6
	},
/obj/item/phone{
	pixel_x = -4;
	pixel_y = -1
	},
/obj/machinery/recharger{
	pixel_y = 3;
	pixel_x = 7
	},
/obj/structure/window/reinforced/spawner/directional/south,
/turf/open/floor/carpet/executive,
/area/station/command/heads_quarters/nt_rep)
"Ya" = (
/obj/effect/turf_decal/tile/blue/diagonal_centre,
/obj/structure/sign/poster/official/enlist/directional/south,
/obj/machinery/atmospherics/components/unary/vent_scrubber/on/layer2{
	dir = 1
	},
/obj/machinery/firealarm/directional/west,
/turf/open/floor/iron/dark/diagonal,
/area/station/command/heads_quarters/blueshield)
"Yj" = (
/turf/template_noop,
/area/template_noop)
"YC" = (
/obj/machinery/firealarm/directional/south,
/obj/effect/turf_decal/siding/wood{
	dir = 10
	},
/obj/structure/table/wood,
/obj/item/clipboard{
	pixel_y = 3;
	pixel_x = 2
	},
/obj/structure/window/reinforced/spawner/directional/west,
/obj/item/folder/nanotrasen{
	pixel_x = -2;
	pixel_y = 1
	},
/turf/open/floor/wood/large,
/area/station/command/heads_quarters/nt_rep)
"YU" = (
/obj/effect/turf_decal/siding/wood{
	dir = 1
	},
/obj/machinery/atmospherics/components/unary/vent_pump/on/layer4,
/turf/open/floor/wood/large,
/area/station/command/heads_quarters/nt_rep)
"Za" = (
/obj/machinery/button/curtain{
	id = "ntc_privatecurtains";
	pixel_x = -26;
	req_access = list("cent_general");
	pixel_y = 6
	},
/obj/machinery/light_switch/directional/west{
	pixel_y = -5
	},
/obj/structure/closet/secure_closet/nanotrasen_consultant,
/turf/open/floor/carpet/executive,
/area/station/command/heads_quarters/nt_rep)
"Zb" = (
/obj/machinery/atmospherics/components/unary/vent_pump/on/layer4{
	dir = 4
	},
/turf/open/floor/carpet/blue,
/area/station/command/heads_quarters/blueshield)
"Zi" = (
/obj/item/paper_bin{
	pixel_y = 5;
	pixel_x = -4
	},
/obj/item/stamp/granted{
	pixel_x = 8;
	pixel_y = 12
	},
/obj/item/stamp/denied{
	pixel_x = 8;
	pixel_y = 6
	},
/obj/structure/table/reinforced/titaniumglass,
/obj/item/pen/fountain/nanotrasen{
	pixel_y = 5;
	pixel_x = -4
	},
/obj/machinery/requests_console/directional/east{
	name = "Nanotrasen Consultant's Requests Console";
	department = "Nanotrasen Consultant's Desk"
	},
/obj/effect/mapping_helpers/requests_console/information,
/obj/effect/mapping_helpers/requests_console/assistance,
/obj/item/stamp/head/ntc{
	pixel_x = 8
	},
/obj/structure/window/reinforced/spawner/directional/south,
/obj/effect/mapping_helpers/requests_console/announcement,
/turf/open/floor/carpet/executive,
/area/station/command/heads_quarters/nt_rep)
"Zk" = (
/obj/machinery/modular_computer/preset/time_clock/directional/south,
/obj/effect/turf_decal/trimline/blue/filled/corner{
	dir = 8
	},
/obj/effect/turf_decal/trimline/dark/corner{
	dir = 8
	},
/obj/structure/cable,
/obj/machinery/atmospherics/pipe/smart/manifold4w/supply/hidden/layer4,
/obj/machinery/atmospherics/pipe/smart/manifold4w/scrubbers/hidden/layer2,
/turf/open/floor/iron,
/area/station/hallway/primary/central)
"Zq" = (
/obj/effect/turf_decal/siding/wood{
	dir = 1
	},
/obj/structure/chair/wood{
	dir = 1
	},
/turf/open/floor/wood/large,
/area/station/command/heads_quarters/nt_rep)
"ZI" = (
/obj/structure/cable,
/obj/machinery/atmospherics/pipe/smart/manifold4w/supply/hidden/layer4,
/obj/machinery/atmospherics/pipe/smart/manifold4w/scrubbers/hidden/layer2,
/obj/effect/turf_decal/tile/neutral{
	dir = 8
	},
/turf/open/floor/iron,
/area/station/hallway/primary/central)

(1,1,1) = {"
DX
DX
DX
DX
DX
aP
DX
DX
DX
Yj
Yj
Yj
Yj
Yj
"}
(2,1,1) = {"
DX
Ru
Za
Mk
Th
tV
lY
Nq
DX
DX
Yj
Yj
Yj
Yj
"}
(3,1,1) = {"
DX
SP
Wq
Wq
XN
YU
Ll
OA
eE
DX
Yj
Yj
Yj
Yj
"}
(4,1,1) = {"
DX
QS
rl
qW
mT
Zq
AH
Ef
vU
DX
Yj
Yj
Yj
Yj
"}
(5,1,1) = {"
DX
gW
UW
BD
Zi
ti
GJ
wZ
zF
DX
Yj
Yj
Yj
Yj
"}
(6,1,1) = {"
Or
Ke
Ke
Ke
DX
aW
dK
as
YC
DX
DX
Yj
Yj
Yj
"}
(7,1,1) = {"
sp
vy
vy
tE
Ke
Ke
pV
nO
Xs
aB
DX
Yj
Yj
Yj
"}
(8,1,1) = {"
Yj
Yj
Yj
cF
hC
Ke
OR
bR
FE
dH
DX
te
Yj
Yj
"}
(9,1,1) = {"
Yj
Yj
Yj
Yj
hC
Ke
Ke
cZ
zJ
DX
DX
te
Yj
Yj
"}
(10,1,1) = {"
Yj
Yj
Yj
Yj
jM
qI
FB
fh
DX
DX
NR
NR
NR
Yj
"}
(11,1,1) = {"
Yj
Yj
Yj
Yj
Yj
Zk
DX
DX
DX
fE
ty
qG
NR
Yj
"}
(12,1,1) = {"
Yj
Yj
Yj
Yj
Yj
Oo
cA
qi
Bj
Zb
HG
lD
NR
Yj
"}
(13,1,1) = {"
Yj
Yj
Yj
Yj
Yj
Yj
Vx
NM
pF
ax
hI
ei
NR
NR
"}
(14,1,1) = {"
Yj
Yj
Yj
Yj
Yj
Yj
wV
NR
NR
IO
LC
yi
jX
NR
"}
(15,1,1) = {"
Yj
Yj
Yj
Yj
Yj
Yj
Oo
ZI
qi
gj
WE
Ea
kB
NR
"}
(16,1,1) = {"
Yj
Yj
Yj
Yj
Yj
Yj
Yj
ZI
NR
NR
NR
kS
NR
NR
"}
(17,1,1) = {"
Yj
Yj
Yj
Yj
Yj
Yj
Yj
ZI
NR
NB
Ks
bX
Ya
NR
"}
(18,1,1) = {"
Yj
Yj
Yj
Yj
Yj
Yj
Yj
ZI
NR
PQ
fs
mX
Lo
NR
"}
(19,1,1) = {"
Yj
Yj
Yj
Yj
Yj
Yj
Yj
ag
NR
NR
NR
NR
NR
NR
"}
