//MAP CONVERTED BY dmm2tgm.py THIS HEADER COMMENT PREVENTS RECONVERSION, DO NOT REMOVE
"aq" = (
/obj/structure/window/reinforced/tinted/spawner/directional/east,
/obj/structure/window/reinforced/tinted/spawner/directional/west,
/obj/structure/window/reinforced/tinted/spawner/directional/south,
/obj/effect/turf_decal/siding/thinplating_new/dark/end,
/obj/structure/flora/bush/jungle,
/obj/structure/flora/bush/lavendergrass/style_random,
/obj/structure/hedge/opaque,
/obj/structure/window/reinforced/tinted/spawner/directional/north,
/turf/open/floor/grass,
/area/station/security/medical)
"at" = (
/obj/structure/table/optable,
/obj/item/radio/intercom/directional/south,
/obj/machinery/light/directional/south,
/obj/effect/turf_decal/trimline/dark_red/filled/line{
	dir = 1
	},
/obj/effect/turf_decal/trimline/dark/line{
	dir = 1
	},
/obj/item/wallframe/defib_mount,
/turf/open/floor/iron/dark/smooth_edge,
/area/station/security/medical)
"aL" = (
/obj/structure/bed/medical/emergency{
	dir = 1
	},
/obj/item/bedsheet/medical,
/obj/machinery/iv_drip,
/obj/machinery/firealarm/directional/east,
/obj/effect/turf_decal/trimline/dark_red/filled/line{
	dir = 5
	},
/turf/open/floor/iron/white,
/area/station/security/medical)
"de" = (
/turf/closed/wall/r_wall,
/area/station/security/breakroom)
"dh" = (
/obj/effect/turf_decal/trimline/dark_red/filled/line,
/turf/open/floor/iron/white,
/area/station/security/medical)
"hj" = (
/turf/template_noop,
/area/template_noop)
"kb" = (
/obj/structure/table/glass,
/obj/item/reagent_containers/spray/cleaner{
	pixel_x = -15;
	pixel_y = 2
	},
/obj/item/folder/white{
	pixel_x = -4;
	pixel_y = 2
	},
/obj/item/folder/red{
	pixel_x = 3
	},
/obj/item/pen,
/obj/effect/turf_decal/trimline/dark_red/filled/line{
	dir = 1
	},
/obj/machinery/atmospherics/components/unary/vent_pump/on/layer4{
	dir = 4
	},
/turf/open/floor/iron/white,
/area/station/security/medical)
"mF" = (
/obj/effect/turf_decal/trimline/dark_red/filled/corner{
	dir = 4
	},
/obj/effect/turf_decal/trimline/dark_red/filled/corner{
	dir = 1
	},
/obj/structure/cable,
/obj/machinery/atmospherics/pipe/smart/manifold4w/supply/hidden/layer4,
/obj/machinery/atmospherics/pipe/smart/manifold4w/scrubbers/hidden/layer2,
/obj/structure/disposalpipe/segment,
/turf/open/floor/iron/white,
/area/station/security/medical)
"pH" = (
/obj/machinery/holopad,
/obj/effect/turf_decal/trimline/dark_red/filled/corner,
/obj/effect/turf_decal/trimline/dark_red/filled/corner{
	dir = 8
	},
/obj/structure/cable,
/obj/machinery/atmospherics/pipe/smart/manifold4w/supply/hidden/layer4,
/obj/machinery/atmospherics/pipe/smart/manifold4w/scrubbers/hidden/layer2,
/obj/structure/disposalpipe/segment{
	dir = 9
	},
/turf/open/floor/iron/white,
/area/station/security/medical)
"qN" = (
/obj/structure/sign/departments/medbay/alt,
/turf/closed/wall/r_wall,
/area/station/security/medical)
"uJ" = (
/obj/structure/rack,
/obj/item/storage/box/bodybags,
/obj/item/clothing/under/rank/medical/scrubs/purple,
/obj/item/clothing/under/rank/medical/scrubs/purple{
	pixel_x = 2;
	pixel_y = 4
	},
/obj/item/clothing/gloves/latex,
/obj/item/healthanalyzer,
/obj/effect/turf_decal/siding/dark_red{
	dir = 1
	},
/obj/structure/extinguisher_cabinet/directional/west,
/obj/machinery/power/apc/auto_name/directional/south,
/obj/structure/cable,
/obj/machinery/camera/autoname/directional/west,
/obj/item/storage/portable_chem_mixer,
/obj/item/reagent_containers/cup/tube,
/obj/item/reagent_containers/cup/tube,
/turf/open/floor/iron/dark,
/area/station/security/medical)
"uW" = (
/turf/closed/wall/r_wall,
/area/station/maintenance/starboard/central)
"vT" = (
/obj/effect/turf_decal/trimline/dark_red/filled/line,
/obj/effect/turf_decal/trimline/dark_red/filled/corner{
	dir = 1
	},
/obj/structure/cable,
/obj/machinery/atmospherics/pipe/smart/manifold4w/supply/hidden/layer4,
/obj/machinery/atmospherics/pipe/smart/manifold4w/scrubbers/hidden/layer2,
/obj/structure/disposalpipe/segment{
	dir = 4
	},
/turf/open/floor/iron/white,
/area/station/security/medical)
"wN" = (
/obj/machinery/door/airlock/maintenance{
	name = "Brig Infirmary Maintenance"
	},
/obj/structure/cable,
/obj/effect/mapping_helpers/airlock/access/all/security/general,
/obj/machinery/atmospherics/pipe/smart/manifold4w/supply/hidden/layer4,
/obj/machinery/atmospherics/pipe/smart/manifold4w/scrubbers/hidden/layer2,
/obj/structure/disposalpipe/segment{
	dir = 4
	},
/turf/open/floor/plating,
/area/station/maintenance/starboard/central)
"Be" = (
/obj/effect/turf_decal/siding/dark_red{
	dir = 1
	},
/obj/structure/window/reinforced/spawner/directional/east,
/obj/item/storage/medkit/regular,
/obj/item/reagent_containers/cup/bottle/multiver,
/obj/item/reagent_containers/syringe,
/obj/machinery/airalarm/directional/south,
/obj/item/storage/medkit/brute,
/obj/item/storage/medkit/fire,
/obj/item/storage/medkit/o2,
/obj/item/storage/medkit/toxin,
/obj/structure/rack,
/turf/open/floor/iron/dark,
/area/station/security/medical)
"Cn" = (
/obj/effect/spawner/structure/window/reinforced,
/obj/structure/cable,
/turf/open/floor/plating,
/area/station/security/medical)
"Dt" = (
/obj/machinery/light_switch/directional/west,
/obj/structure/table/glass,
/obj/machinery/computer/records/medical/laptop,
/obj/machinery/wall_healer/directional/north,
/obj/effect/turf_decal/trimline/dark_red/filled/line{
	dir = 9
	},
/obj/machinery/camera/autoname/directional/north,
/turf/open/floor/iron/white,
/area/station/security/medical)
"Du" = (
/obj/effect/turf_decal/trimline/dark_red/filled/line,
/obj/structure/cable,
/obj/machinery/atmospherics/pipe/smart/manifold4w/supply/hidden/layer4,
/obj/machinery/atmospherics/pipe/smart/manifold4w/scrubbers/hidden/layer2,
/obj/structure/disposalpipe/segment{
	dir = 4
	},
/turf/open/floor/iron/white,
/area/station/security/medical)
"Em" = (
/turf/closed/wall/r_wall,
/area/station/security/medical)
"Ge" = (
/obj/effect/turf_decal/siding/dark_red{
	dir = 1
	},
/obj/effect/turf_decal/trimline/dark_red/filled/corner,
/obj/effect/turf_decal/trimline/dark/corner,
/turf/open/floor/iron/dark/smooth_corner,
/area/station/security/medical)
"Nf" = (
/obj/machinery/door/airlock/medical/glass{
	name = "Infirmary"
	},
/obj/machinery/door/firedoor,
/obj/structure/cable,
/obj/machinery/atmospherics/pipe/smart/manifold4w/supply/hidden/layer4,
/obj/machinery/atmospherics/pipe/smart/manifold4w/scrubbers/hidden/layer2,
/obj/structure/disposalpipe/segment,
/obj/effect/mapping_helpers/airlock/access/all/security/general,
/turf/open/floor/iron/dark,
/area/station/security/medical)
"Pt" = (
/obj/machinery/door/airlock/security/glass{
	name = "Break Room"
	},
/obj/effect/mapping_helpers/airlock/access/all/security/general,
/obj/machinery/door/firedoor,
/turf/open/floor/iron/dark,
/area/station/security/breakroom)
"Ri" = (
/obj/effect/turf_decal/siding/dark_red{
	dir = 1
	},
/obj/effect/turf_decal/trimline/dark_red/filled/line,
/obj/effect/turf_decal/trimline/dark/line,
/turf/open/floor/iron/dark/smooth_edge{
	dir = 1
	},
/area/station/security/medical)
"RV" = (
/obj/effect/turf_decal/trimline/dark_red/filled/line,
/obj/effect/turf_decal/trimline/dark_red/filled/corner{
	dir = 4
	},
/obj/effect/landmark/start/security_medic,
/turf/open/floor/iron/white,
/area/station/security/medical)
"Tl" = (
/obj/item/kirbyplants/random,
/obj/effect/turf_decal/trimline/dark_red/filled/line{
	dir = 1
	},
/obj/machinery/atmospherics/components/unary/vent_scrubber/on/layer2{
	dir = 8
	},
/turf/open/floor/iron/white,
/area/station/security/medical)
"Vo" = (
/obj/structure/table/reinforced,
/obj/machinery/status_display/ai/directional/east,
/obj/effect/turf_decal/trimline/dark_red/filled/corner{
	dir = 1
	},
/obj/effect/turf_decal/trimline/dark/corner{
	dir = 1
	},
/obj/item/storage/medkit/surgery,
/turf/open/floor/iron/dark/smooth_corner{
	dir = 1
	},
/area/station/security/medical)
"Wf" = (
/obj/machinery/computer/operating{
	dir = 1
	},
/obj/effect/turf_decal/trimline/dark_red/filled/corner{
	dir = 4
	},
/obj/effect/turf_decal/trimline/dark/corner{
	dir = 4
	},
/turf/open/floor/iron/dark/smooth_corner{
	dir = 4
	},
/area/station/security/medical)
"ZJ" = (
/obj/effect/turf_decal/siding/dark_red{
	dir = 1
	},
/obj/structure/sign/poster/official/cleanliness/directional/east,
/obj/structure/sink/directional/west,
/obj/effect/turf_decal/trimline/dark_red/filled/corner{
	dir = 8
	},
/obj/effect/turf_decal/trimline/dark/corner{
	dir = 8
	},
/turf/open/floor/iron/dark/smooth_corner{
	dir = 8
	},
/area/station/security/medical)

(1,1,1) = {"
uW
uW
wN
uW
uW
hj
"}
(2,1,1) = {"
Em
Dt
vT
uJ
uW
hj
"}
(3,1,1) = {"
Cn
kb
Du
Be
uW
uW
"}
(4,1,1) = {"
Nf
mF
pH
Ge
Wf
aq
"}
(5,1,1) = {"
Cn
Tl
dh
Ri
at
Em
"}
(6,1,1) = {"
qN
aL
RV
ZJ
Vo
aq
"}
(7,1,1) = {"
de
de
Pt
de
de
de
"}
