//MAP CONVERTED BY dmm2tgm.py THIS HEADER COMMENT PREVENTS RECONVERSION, DO NOT REMOVE
"ah" = (
/obj/effect/turf_decal/trimline/blue/filled/line,
/obj/effect/turf_decal/trimline/dark/line,
/obj/structure/cable,
/obj/machinery/atmospherics/pipe/smart/manifold4w/supply/hidden/layer4,
/obj/machinery/atmospherics/pipe/smart/manifold4w/scrubbers/hidden/layer2,
/turf/open/floor/iron,
/area/station/hallway/primary/central)
"ai" = (
/obj/effect/turf_decal/siding/wood{
	dir = 1
	},
/obj/structure/chair/wood{
	dir = 1
	},
/turf/open/floor/wood/large,
/area/station/command/heads_quarters/nt_rep)
"ba" = (
/obj/machinery/atmospherics/pipe/smart/manifold4w/supply/hidden/layer4,
/obj/machinery/atmospherics/pipe/smart/manifold4w/scrubbers/hidden/layer2,
/obj/effect/turf_decal/siding/wood/corner{
	dir = 4
	},
/turf/open/floor/wood/large,
/area/station/command/heads_quarters/nt_rep)
"bl" = (
/obj/effect/turf_decal/siding/wood,
/obj/machinery/holopad,
/obj/machinery/atmospherics/pipe/smart/manifold4w/supply/hidden/layer4,
/obj/effect/landmark/event_spawn,
/turf/open/floor/wood/large,
/area/station/command/heads_quarters/nt_rep)
"bs" = (
/obj/effect/turf_decal/siding/wood{
	dir = 8
	},
/obj/structure/table/wood,
/obj/item/paper_bin{
	pixel_y = 5;
	pixel_x = -4
	},
/obj/item/pen{
	pixel_y = 5;
	pixel_x = -4
	},
/obj/item/stamp/granted{
	pixel_y = 9;
	pixel_x = 8
	},
/obj/item/stamp/denied{
	pixel_x = 8;
	pixel_y = 2
	},
/obj/structure/window/reinforced/spawner/directional/west,
/turf/open/floor/wood/large,
/area/station/command/heads_quarters/nt_rep)
"bx" = (
/obj/structure/chair/sofa/right/brown{
	dir = 4;
	color = "#462f1c"
	},
/obj/machinery/airalarm/directional/west,
/obj/item/radio/intercom/directional/south,
/turf/open/floor/carpet/cyan,
/area/station/command/heads_quarters/nt_rep)
"bE" = (
/obj/effect/spawner/structure/window/reinforced,
/obj/structure/cable,
/obj/structure/curtain/cloth/fancy/mechanical{
	icon_state = "bathroom-open";
	icon_type = "bathroom";
	id = "ntc_privatecurtains";
	name = "expensive curtain";
	color = "#2E7DA5";
	desc = "An expensive set of excellent cloth drapes."
	},
/turf/open/floor/plating,
/area/station/command/heads_quarters/nt_rep)
"bY" = (
/obj/machinery/button/curtain{
	id = "ntc_privatecurtains";
	pixel_x = -26;
	req_access = list("cent_general");
	pixel_y = 6
	},
/obj/machinery/light_switch/directional/west{
	pixel_y = -5
	},
/obj/structure/closet/secure_closet/nanotrasen_consultant,
/turf/open/floor/carpet/executive,
/area/station/command/heads_quarters/nt_rep)
"dd" = (
/obj/structure/cable,
/obj/machinery/atmospherics/pipe/smart/manifold4w/supply/hidden/layer4,
/obj/machinery/atmospherics/pipe/smart/manifold4w/scrubbers/hidden/layer2,
/obj/structure/disposalpipe/segment,
/obj/effect/turf_decal/tile/neutral{
	dir = 8
	},
/turf/open/floor/iron,
/area/station/hallway/primary/central)
"dF" = (
/obj/effect/turf_decal/tile/neutral{
	dir = 8
	},
/obj/structure/cable,
/obj/machinery/atmospherics/pipe/smart/manifold4w/supply/hidden/layer4,
/obj/machinery/atmospherics/pipe/smart/manifold4w/scrubbers/hidden/layer2,
/obj/structure/disposalpipe/segment,
/turf/open/floor/iron,
/area/station/hallway/primary/central)
"en" = (
/obj/structure/chair/sofa/left/brown{
	dir = 8;
	color = "#462f1c"
	},
/obj/structure/sign/poster/official/enlist/directional/south,
/obj/machinery/camera/autoname/directional/south,
/turf/open/floor/carpet/cyan,
/area/station/command/heads_quarters/nt_rep)
"fd" = (
/obj/structure/cable,
/obj/machinery/atmospherics/pipe/smart/manifold4w/supply/hidden/layer4,
/obj/machinery/atmospherics/pipe/smart/manifold4w/scrubbers/hidden/layer2,
/obj/structure/disposalpipe/segment{
	dir = 4
	},
/obj/effect/turf_decal/tile/neutral{
	dir = 8
	},
/turf/open/floor/iron,
/area/station/hallway/primary/central)
"fk" = (
/obj/machinery/atmospherics/pipe/smart/manifold4w/supply/hidden/layer4,
/obj/machinery/atmospherics/pipe/smart/manifold4w/scrubbers/hidden/layer2,
/obj/structure/cable,
/obj/machinery/light_switch/directional/east,
/obj/effect/turf_decal/siding/wood/end{
	dir = 4
	},
/turf/open/floor/wood/large,
/area/station/command/heads_quarters/nt_rep)
"hp" = (
/obj/effect/turf_decal/tile/neutral{
	dir = 8
	},
/obj/structure/cable,
/obj/machinery/atmospherics/pipe/smart/manifold4w/supply/hidden/layer4,
/obj/machinery/atmospherics/pipe/smart/manifold4w/scrubbers/hidden/layer2,
/obj/structure/disposalpipe/segment{
	dir = 5
	},
/turf/open/floor/iron,
/area/station/hallway/primary/central)
"hu" = (
/obj/structure/chair/comfy/brown,
/obj/effect/landmark/start/nanotrasen_consultant,
/turf/open/floor/carpet/executive,
/area/station/command/heads_quarters/nt_rep)
"iu" = (
/obj/item/paper_bin{
	pixel_y = 5;
	pixel_x = -4
	},
/obj/item/stamp/granted{
	pixel_y = 12;
	pixel_x = 8
	},
/obj/item/stamp/denied{
	pixel_x = 8;
	pixel_y = 6
	},
/obj/structure/table/reinforced/titaniumglass,
/obj/item/pen/fountain/nanotrasen{
	pixel_y = 5;
	pixel_x = -4
	},
/obj/machinery/requests_console/directional/east{
	name = "Nanotrasen Consultant's Requests Console";
	department = "Nanotrasen Consultant's Desk"
	},
/obj/effect/mapping_helpers/requests_console/announcement,
/obj/effect/mapping_helpers/requests_console/information,
/obj/effect/mapping_helpers/requests_console/assistance,
/obj/item/stamp/head/ntc{
	pixel_x = 8
	},
/obj/structure/window/reinforced/spawner/directional/south,
/turf/open/floor/carpet/executive,
/area/station/command/heads_quarters/nt_rep)
"iz" = (
/obj/machinery/firealarm/directional/south,
/obj/effect/turf_decal/siding/wood{
	dir = 10
	},
/obj/structure/table/wood,
/obj/item/clipboard{
	pixel_y = 3;
	pixel_x = 2
	},
/obj/structure/window/reinforced/spawner/directional/west,
/obj/item/folder/nanotrasen{
	pixel_x = -2;
	pixel_y = 1
	},
/turf/open/floor/wood/large,
/area/station/command/heads_quarters/nt_rep)
"jW" = (
/obj/machinery/door/airlock/maintenance,
/obj/effect/mapping_helpers/airlock/access/all/cent_com/nanotrasenstaff,
/turf/open/floor/iron/dark/textured_large,
/area/station/command/heads_quarters/nt_rep)
"lx" = (
/obj/structure/table/reinforced/titaniumglass,
/obj/item/clipboard{
	pixel_y = 3;
	pixel_x = -5
	},
/obj/item/folder/nanotrasen{
	pixel_y = 2;
	pixel_x = -4
	},
/obj/item/reagent_containers/cup/glass/mug/nanotrasen{
	pixel_y = 11;
	pixel_x = 11
	},
/obj/item/sign/flag/nanotrasen{
	pixel_x = 5
	},
/obj/structure/window/reinforced/spawner/directional/south,
/turf/open/floor/carpet/executive,
/area/station/command/heads_quarters/nt_rep)
"mG" = (
/turf/open/floor/carpet/executive,
/area/station/command/heads_quarters/nt_rep)
"nf" = (
/obj/effect/turf_decal/siding/wood/corner,
/obj/effect/turf_decal/siding/wood/corner{
	dir = 8
	},
/obj/structure/chair/office{
	dir = 8
	},
/obj/effect/landmark/start/nanotrasen_crew_trainer,
/turf/open/floor/wood/large,
/area/station/command/heads_quarters/nt_rep)
"nl" = (
/obj/machinery/door/window/brigdoor/left/directional/south{
	name = "Nanotrasen Consultant's Desk";
	req_access = list("cent_captain")
	},
/obj/structure/sign/flag/nanotrasen/directional/west,
/turf/open/floor/carpet/executive,
/area/station/command/heads_quarters/nt_rep)
"nG" = (
/obj/effect/turf_decal/siding/wood{
	dir = 1
	},
/obj/effect/turf_decal/siding/wood,
/obj/structure/noticeboard/directional/north,
/obj/structure/table/wood/fancy/blue,
/obj/machinery/coffeemaker/impressa{
	pixel_y = 8;
	pixel_x = 8
	},
/obj/item/storage/fancy/coffee_condi_display{
	pixel_x = -15;
	pixel_y = 12
	},
/obj/item/reagent_containers/cup/glass/mug/nanotrasen{
	pixel_x = -15;
	pixel_y = 3
	},
/obj/item/reagent_containers/cup/glass/mug/nanotrasen{
	pixel_x = -6
	},
/turf/open/floor/wood/large,
/area/station/command/heads_quarters/nt_rep)
"nL" = (
/obj/effect/turf_decal/siding/wood{
	dir = 5
	},
/obj/structure/hedge,
/turf/open/floor/wood/large,
/area/station/command/heads_quarters/nt_rep)
"oa" = (
/obj/structure/safe/floor/ntc,
/obj/item/folder/ntc_documents,
/obj/item/reagent_containers/cup/glass/flask/gold,
/obj/item/reagent_containers/applicator/pill/cyanide,
/obj/item/photo{
	name = "department group photo";
	desc = "A recent photo of all the Internal Affairs staff, the Affairs Director, Assistant Director, and all the Executive Officers, and Crew Trainers. You almost miss the good days.."
	},
/obj/item/reagent_containers/cup/glass/bottle/rum/aged,
/obj/item/gun/energy/pulse/pistol/m1911/fake_ntc,
/obj/item/toy/figure/dsquad,
/obj/item/coin/adamantine,
/obj/item/encryptionkey/headset_cent,
/turf/open/floor/carpet/executive,
/area/station/command/heads_quarters/nt_rep)
"qS" = (
/obj/machinery/atmospherics/pipe/smart/manifold4w/supply/hidden/layer4,
/obj/effect/turf_decal/siding/wood,
/obj/effect/landmark/start/nanotrasen_crew_trainer,
/turf/open/floor/wood/large,
/area/station/command/heads_quarters/nt_rep)
"re" = (
/obj/effect/turf_decal/siding/wood,
/obj/machinery/atmospherics/pipe/smart/manifold4w/supply/hidden/layer4,
/turf/open/floor/wood/large,
/area/station/command/heads_quarters/nt_rep)
"sh" = (
/obj/machinery/atmospherics/pipe/smart/manifold4w/scrubbers/hidden/layer2,
/obj/machinery/atmospherics/pipe/smart/manifold4w/supply/hidden/layer4,
/obj/structure/cable,
/obj/effect/turf_decal/tile/neutral{
	dir = 8
	},
/turf/open/floor/iron,
/area/station/hallway/primary/central)
"sM" = (
/obj/effect/turf_decal/siding/wood{
	dir = 1
	},
/turf/open/floor/wood/large,
/area/station/command/heads_quarters/nt_rep)
"tb" = (
/obj/effect/turf_decal/siding/wood/end{
	dir = 4
	},
/obj/machinery/status_display/evac/directional/north,
/obj/structure/aquarium/prefilled,
/obj/item/reagent_containers/cup/fish_feed{
	pixel_y = 17;
	pixel_x = -3
	},
/turf/open/floor/wood/large,
/area/station/command/heads_quarters/nt_rep)
"ts" = (
/obj/structure/sign/directions/dorms/directional/west{
	pixel_y = 8;
	pixel_x = 0
	},
/obj/structure/sign/directions/evac/directional/west{
	pixel_x = 0
	},
/obj/structure/sign/directions/engineering/directional/west{
	pixel_y = -8;
	dir = 2;
	pixel_x = 0
	},
/turf/closed/wall/r_wall,
/area/station/command/heads_quarters/nt_rep)
"tY" = (
/turf/closed/wall/r_wall,
/area/station/command/heads_quarters/nt_rep)
"ve" = (
/obj/structure/chair/sofa/right/brown{
	dir = 8;
	color = "#462f1c"
	},
/turf/open/floor/carpet/cyan,
/area/station/command/heads_quarters/nt_rep)
"xx" = (
/obj/effect/turf_decal/siding/wood/end{
	dir = 8
	},
/obj/structure/sign/clock/directional/west,
/obj/machinery/status_display/ai/directional/north,
/obj/structure/table/wood/fancy/blue,
/obj/item/reagent_containers/cup/glass/trophy/gold_cup{
	pixel_y = 14;
	pixel_x = 1
	},
/turf/open/floor/wood/large,
/area/station/command/heads_quarters/nt_rep)
"AT" = (
/obj/machinery/fax{
	fax_name = "Nanotrasen Consultant's Office";
	name = "Nanotrasen Consultant's Fax Machine"
	},
/obj/structure/table/wood/fancy/blue,
/obj/effect/turf_decal/siding/wood{
	dir = 1
	},
/obj/effect/turf_decal/siding/wood,
/obj/machinery/keycard_auth/wall_mounted/directional/north,
/turf/open/floor/wood/large,
/area/station/command/heads_quarters/nt_rep)
"AW" = (
/obj/structure/sign/calendar/directional/south,
/obj/machinery/light/warm/directional/south,
/obj/effect/turf_decal/siding/wood,
/obj/structure/filingcabinet/medical{
	pixel_x = -10;
	icon_state = "employmentcabinet";
	name = "medical records filing cabinet"
	},
/obj/structure/filingcabinet/employment{
	name = "employment forms filing cabinet"
	},
/obj/structure/filingcabinet/security{
	pixel_x = 10;
	icon_state = "employmentcabinet";
	name = "security records filing cabinet"
	},
/turf/open/floor/wood/large,
/area/station/command/heads_quarters/nt_rep)
"Bg" = (
/obj/effect/turf_decal/siding/wood/end,
/obj/machinery/status_display/ai/directional/south,
/obj/structure/closet/secure_closet/nanotrasen_crew_trainer,
/obj/item/storage/lunchbox/nanotrasen,
/turf/open/floor/wood/large,
/area/station/command/heads_quarters/nt_rep)
"BE" = (
/turf/template_noop,
/area/template_noop)
"BP" = (
/obj/structure/table/wood,
/obj/item/taperecorder{
	pixel_y = 2;
	pixel_x = -5
	},
/obj/item/tape{
	pixel_x = 4
	},
/obj/machinery/vending/boozeomat{
	pixel_y = -32;
	density = 0;
	req_access = list("cent_general")
	},
/obj/machinery/light/directional/south,
/turf/open/floor/carpet/cyan,
/area/station/command/heads_quarters/nt_rep)
"CS" = (
/obj/machinery/modular_computer/preset/command{
	dir = 8
	},
/turf/open/floor/carpet/executive,
/area/station/command/heads_quarters/nt_rep)
"DI" = (
/obj/structure/extinguisher_cabinet/directional/south,
/obj/machinery/power/apc/auto_name/directional/east,
/obj/structure/cable,
/obj/structure/hedge,
/obj/effect/turf_decal/siding/wood{
	dir = 6
	},
/turf/open/floor/wood/large,
/area/station/command/heads_quarters/nt_rep)
"Kf" = (
/obj/machinery/door/firedoor,
/obj/structure/cable,
/obj/machinery/atmospherics/pipe/smart/manifold4w/scrubbers/hidden/layer2,
/obj/machinery/atmospherics/pipe/smart/manifold4w/supply/hidden/layer4,
/obj/machinery/door/airlock/corporate{
	name = "Nanotrasen Internal Affairs Office"
	},
/obj/effect/landmark/navigate_destination/autoname,
/obj/effect/mapping_helpers/airlock/unres,
/obj/effect/mapping_helpers/airlock/access/all/cent_com/nanotrasenstaff,
/turf/open/floor/iron/dark/textured_large,
/area/station/command/heads_quarters/nt_rep)
"Mt" = (
/obj/machinery/atmospherics/pipe/smart/manifold4w/supply/hidden/layer4,
/obj/machinery/atmospherics/pipe/smart/manifold4w/scrubbers/hidden/layer2,
/obj/structure/cable,
/obj/effect/turf_decal/siding/wood{
	dir = 1
	},
/obj/effect/turf_decal/siding/wood/corner,
/turf/open/floor/wood/large,
/area/station/command/heads_quarters/nt_rep)
"MX" = (
/obj/structure/sign/calendar/directional/west,
/obj/machinery/light/directional/west,
/turf/open/floor/carpet/executive,
/area/station/command/heads_quarters/nt_rep)
"NR" = (
/obj/machinery/modular_computer/preset/time_clock/directional/south,
/obj/effect/turf_decal/trimline/blue/filled/corner{
	dir = 8
	},
/obj/effect/turf_decal/trimline/dark/corner{
	dir = 8
	},
/obj/structure/cable,
/obj/machinery/atmospherics/pipe/smart/manifold4w/supply/hidden/layer4,
/obj/machinery/atmospherics/pipe/smart/manifold4w/scrubbers/hidden/layer2,
/turf/open/floor/iron,
/area/station/hallway/primary/central)
"Pv" = (
/obj/structure/table/reinforced/titaniumglass,
/obj/item/flashlight/lamp/green{
	pixel_y = 13;
	pixel_x = -6
	},
/obj/item/phone{
	pixel_x = -4;
	pixel_y = -1
	},
/obj/machinery/recharger{
	pixel_y = 3;
	pixel_x = 7
	},
/obj/structure/window/reinforced/spawner/directional/south,
/turf/open/floor/carpet/executive,
/area/station/command/heads_quarters/nt_rep)
"Qn" = (
/obj/machinery/computer/station_goal{
	dir = 8
	},
/turf/open/floor/carpet/executive,
/area/station/command/heads_quarters/nt_rep)
"Uy" = (
/obj/machinery/atmospherics/pipe/smart/manifold4w/supply/hidden/layer4,
/obj/effect/turf_decal/siding/wood{
	dir = 5
	},
/obj/machinery/photocopier/prebuilt,
/obj/item/toy/plush/skyrat/ian/lisa{
	pixel_y = 11
	},
/turf/open/floor/wood/large,
/area/station/command/heads_quarters/nt_rep)
"UO" = (
/obj/machinery/atmospherics/pipe/smart/manifold4w/supply/hidden/layer4,
/obj/effect/turf_decal/siding/wood{
	dir = 1
	},
/turf/open/floor/wood/large,
/area/station/command/heads_quarters/nt_rep)
"Vi" = (
/obj/machinery/atmospherics/pipe/smart/manifold4w/scrubbers/hidden/layer2,
/obj/machinery/atmospherics/pipe/smart/manifold4w/supply/hidden/layer4,
/obj/structure/cable,
/turf/open/floor/iron,
/area/station/hallway/primary/central)
"WP" = (
/obj/machinery/atmospherics/components/unary/vent_scrubber/on/layer2{
	dir = 4
	},
/turf/open/floor/wood/large,
/area/station/command/heads_quarters/nt_rep)
"WW" = (
/obj/structure/hedge,
/obj/effect/turf_decal/siding/wood/end,
/turf/open/floor/wood/large,
/area/station/command/heads_quarters/nt_rep)
"WZ" = (
/obj/effect/mapping_helpers/turn_off_lights_with_lightswitch,
/obj/effect/turf_decal/siding/wood{
	dir = 1
	},
/turf/open/floor/wood/large,
/area/station/command/heads_quarters/nt_rep)
"XM" = (
/obj/structure/chair/sofa/left/brown{
	dir = 4;
	color = "#462f1c"
	},
/turf/open/floor/carpet/cyan,
/area/station/command/heads_quarters/nt_rep)
"YG" = (
/obj/effect/turf_decal/siding/wood{
	dir = 8
	},
/obj/effect/turf_decal/siding/wood/corner,
/obj/machinery/newscaster/directional/west,
/obj/effect/spawner/random/ntc_pet,
/obj/structure/bed/dogbed/luxury,
/turf/open/floor/wood/large,
/area/station/command/heads_quarters/nt_rep)
"Zd" = (
/obj/structure/table/wood,
/obj/item/folder/blue{
	pixel_x = -7;
	pixel_y = 3
	},
/obj/item/folder/yellow{
	pixel_x = 6;
	pixel_y = 3
	},
/obj/item/folder/nanotrasen,
/turf/open/floor/carpet/cyan,
/area/station/command/heads_quarters/nt_rep)
"ZD" = (
/obj/machinery/atmospherics/pipe/smart/manifold4w/supply/hidden/layer4,
/obj/effect/turf_decal/siding/wood/corner{
	dir = 4
	},
/obj/effect/turf_decal/siding/wood/corner{
	dir = 8
	},
/turf/open/floor/wood/large,
/area/station/command/heads_quarters/nt_rep)
"ZT" = (
/obj/effect/turf_decal/siding/wood{
	dir = 9
	},
/turf/open/floor/wood/large,
/area/station/command/heads_quarters/nt_rep)

(1,1,1) = {"
tY
tY
tY
tY
tY
jW
tY
tY
tY
BE
BE
"}
(2,1,1) = {"
tY
xx
bY
MX
nl
ZT
YG
WW
tY
tY
BE
"}
(3,1,1) = {"
tY
nG
mG
mG
Pv
sM
re
XM
bx
tY
BE
"}
(4,1,1) = {"
tY
AT
oa
hu
lx
ai
bl
Zd
BP
tY
BE
"}
(5,1,1) = {"
tY
tb
Qn
CS
iu
WZ
qS
ve
en
tY
BE
"}
(6,1,1) = {"
ts
bE
bE
bE
tY
nL
ZD
bs
iz
tY
tY
"}
(7,1,1) = {"
dF
dd
dd
hp
bE
bE
UO
WP
nf
Bg
tY
"}
(8,1,1) = {"
BE
BE
BE
fd
sh
bE
Uy
ba
AW
tY
tY
"}
(9,1,1) = {"
BE
BE
BE
BE
sh
bE
bE
Mt
DI
tY
BE
"}
(10,1,1) = {"
BE
BE
BE
BE
Vi
ah
Kf
fk
tY
tY
BE
"}
(11,1,1) = {"
BE
BE
BE
BE
BE
NR
tY
tY
tY
BE
BE
"}
