//MAP CONVERTED BY dmm2tgm.py THIS HEADER COMMENT PREVENTS RECONVERSION, DO NOT REMOVE
"aq" = (
/turf/closed/wall,
/area/station/maintenance/department/security)
"at" = (
/obj/structure/chair/pillow_small,
/obj/item/clothing/sextoy/dildo{
	pixel_x = 3;
	pixel_y = 1
	},
/obj/machinery/atmospherics/pipe/smart/manifold4w/supply/hidden/layer4,
/obj/item/reagent_containers/cup/glass/bottle/femcum_whiskey{
	pixel_x = 11;
	pixel_y = -2
	},
/obj/effect/turf_decal/siding/purple{
	dir = 8
	},
/obj/effect/turf_decal/siding/dark_red{
	dir = 4
	},
/obj/effect/turf_decal/tile/purple,
/turf/open/floor/iron/dark/diagonal,
/area/station/maintenance/department/security)
"aL" = (
/obj/structure/cable,
/obj/machinery/atmospherics/pipe/smart/manifold4w/scrubbers/hidden/layer2,
/obj/effect/turf_decal/siding/purple,
/obj/effect/turf_decal/siding/dark_red/corner{
	dir = 1
	},
/obj/effect/turf_decal/tile/purple{
	dir = 1
	},
/turf/open/floor/iron/dark/diagonal,
/area/station/maintenance/department/security)
"bb" = (
/turf/open/floor/iron/white,
/area/station/security/medical)
"bW" = (
/obj/effect/turf_decal/tile/red/half/contrasted{
	dir = 8
	},
/obj/structure/table/optable,
/obj/item/wallframe/defib_mount,
/obj/machinery/light/small/directional/north{
	dir = 8
	},
/turf/open/floor/iron/white,
/area/station/security/medical)
"dh" = (
/obj/structure/cable,
/obj/effect/turf_decal/siding/purple/inner_corner,
/obj/effect/turf_decal/tile/purple{
	dir = 1
	},
/turf/open/floor/iron/dark/diagonal,
/area/station/maintenance/department/security)
"ho" = (
/obj/machinery/atmospherics/components/unary/vent_pump/on/layer4{
	dir = 8
	},
/turf/open/floor/iron/white,
/area/station/security/medical)
"hZ" = (
/obj/structure/table,
/obj/effect/turf_decal/tile/red/half/contrasted{
	dir = 4
	},
/obj/machinery/airalarm/directional/east,
/obj/item/folder/white{
	pixel_x = -10;
	pixel_y = 7
	},
/obj/item/folder/red{
	pixel_x = 9;
	pixel_y = 7
	},
/obj/machinery/computer/records/medical/laptop,
/turf/open/floor/iron/white,
/area/station/security/medical)
"ik" = (
/turf/closed/wall,
/area/station/security/medical)
"iE" = (
/obj/machinery/atmospherics/pipe/multiz/scrubbers/visible/layer2,
/obj/machinery/atmospherics/pipe/multiz/supply/visible/layer4,
/turf/open/floor/plating,
/area/station/maintenance/department/security)
"kb" = (
/obj/structure/window/spawner/directional/south,
/obj/structure/bed/medical/emergency,
/obj/effect/turf_decal/tile/red/half/contrasted{
	dir = 8
	},
/obj/item/toy/plush/beeplushie{
	name = "Dr. Bees";
	desc = "When in doubt, just ask yourself: What would Dr. Bees do?."
	},
/obj/structure/sign/poster/contraband/beekind/directional/west,
/turf/open/floor/iron/white,
/area/station/security/medical)
"mF" = (
/obj/machinery/atmospherics/pipe/smart/manifold4w/supply/hidden/layer4,
/obj/machinery/atmospherics/pipe/smart/manifold4w/scrubbers/hidden/layer2,
/obj/structure/cable,
/turf/open/floor/iron/white,
/area/station/security/medical)
"pH" = (
/obj/item/flashlight/glowstick/pink{
	pixel_x = -7;
	pixel_y = -5
	},
/obj/effect/turf_decal/tile/purple/diagonal_centre,
/turf/open/floor/glass/reinforced,
/area/station/maintenance/department/security)
"qy" = (
/obj/effect/spawner/random/decoration/glowstick/on{
	pixel_x = 3;
	pixel_y = 8
	},
/obj/structure/cable,
/obj/machinery/power/apc/auto_name/directional/west,
/obj/effect/turf_decal/siding/dark/corner,
/obj/effect/turf_decal/siding/dark_red{
	dir = 8
	},
/turf/open/floor/iron/dark/diagonal,
/area/station/maintenance/department/security)
"qN" = (
/obj/machinery/atmospherics/pipe/multiz/scrubbers/visible/layer2,
/obj/machinery/atmospherics/pipe/multiz/supply/visible/layer4,
/obj/item/toy/plush/rouny{
	pixel_x = 10;
	pixel_y = 3
	},
/obj/structure/sign/poster/contraband/missing_gloves/directional/east,
/obj/effect/turf_decal/stripes/end{
	dir = 1
	},
/turf/open/floor/iron/dark/diagonal,
/area/station/maintenance/department/security)
"tc" = (
/obj/effect/turf_decal/tile/red/half/contrasted{
	dir = 8
	},
/obj/structure/window/spawner/directional/north,
/obj/machinery/computer/operating{
	dir = 4
	},
/obj/structure/extinguisher_cabinet/directional/west,
/turf/open/floor/iron/white,
/area/station/security/medical)
"uG" = (
/obj/structure/cable,
/obj/machinery/atmospherics/pipe/smart/manifold4w/scrubbers/hidden/layer2,
/obj/machinery/atmospherics/pipe/smart/manifold4w/supply/hidden/layer4,
/turf/open/floor/plating,
/area/station/maintenance/department/security)
"uJ" = (
/obj/item/clothing/mask/surgical,
/obj/item/reagent_containers/spray/cleaner,
/obj/effect/turf_decal/tile/red/half/contrasted{
	dir = 8
	},
/obj/item/storage/medkit/surgery{
	pixel_x = -4;
	pixel_y = 10
	},
/obj/structure/table/reinforced/rglass,
/obj/item/healthanalyzer,
/obj/item/clothing/gloves/latex,
/turf/open/floor/iron/white,
/area/station/security/medical)
"vT" = (
/obj/machinery/portable_atmospherics/canister/nitrous_oxide,
/obj/structure/ladder,
/obj/structure/sign/poster/contraband/andromeda_bitters/directional/south,
/turf/open/floor/plating,
/area/station/maintenance/department/security)
"wN" = (
/turf/closed/wall/r_wall,
/area/station/security/medical)
"xC" = (
/obj/machinery/portable_atmospherics/canister/air,
/obj/item/tank/internals/oxygen,
/turf/open/floor/plating,
/area/station/maintenance/department/security)
"yb" = (
/obj/machinery/vending/dorms,
/obj/item/toy/plush/toaste_plushy{
	pixel_x = 3;
	pixel_y = 20
	},
/obj/item/clothing/mask/leatherwhip{
	pixel_x = -7;
	pixel_y = 22
	},
/obj/item/clothing/head/domina_cap{
	pixel_x = 6;
	pixel_y = 31
	},
/obj/structure/marker_beacon/purple,
/obj/structure/sign/poster/contraband/busty_backdoor_xeno_babes_6/directional/west,
/obj/structure/sign/poster/contraband/crocin_pool/directional/south,
/obj/effect/turf_decal/siding/dark/corner{
	dir = 4
	},
/obj/effect/turf_decal/siding/dark_red{
	dir = 10
	},
/turf/open/floor/iron/dark/diagonal,
/area/station/maintenance/department/security)
"zm" = (
/obj/effect/landmark/start/security_medic,
/turf/open/floor/iron/white,
/area/station/security/medical)
"Am" = (
/obj/structure/cable,
/obj/machinery/atmospherics/pipe/smart/manifold4w/scrubbers/hidden/layer2,
/obj/machinery/atmospherics/pipe/smart/manifold4w/supply/hidden/layer4,
/obj/structure/chair/milking_machine,
/obj/item/clothing/sextoy/vibroring{
	pixel_x = 9;
	pixel_y = -7
	},
/obj/effect/turf_decal/siding/dark_red{
	dir = 5
	},
/turf/open/floor/iron/dark/diagonal,
/area/station/maintenance/department/security)
"Be" = (
/obj/structure/chair/sofa/corp/corner{
	dir = 8
	},
/obj/structure/sign/poster/contraband/double_rainbow/directional/south,
/obj/effect/turf_decal/siding/dark_red{
	dir = 6
	},
/turf/open/floor/iron/dark/diagonal,
/area/station/maintenance/department/security)
"Bw" = (
/obj/structure/chair/pillow_small,
/obj/item/clothing/sextoy/fleshlight{
	pixel_x = 6;
	pixel_y = -7
	},
/obj/item/reagent_containers/cup/glass/bottle/cum_rum{
	pixel_x = -14;
	pixel_y = -5
	},
/obj/effect/turf_decal/siding/purple{
	dir = 1
	},
/obj/effect/turf_decal/siding/dark_red,
/obj/effect/turf_decal/tile/purple,
/turf/open/floor/iron/dark/diagonal,
/area/station/maintenance/department/security)
"BW" = (
/obj/effect/turf_decal/tile/red/half/contrasted{
	dir = 8
	},
/obj/item/reagent_containers/cup/bottle/multiver{
	pixel_x = 3;
	pixel_y = 5
	},
/obj/item/reagent_containers/cup/bottle/epinephrine{
	pixel_x = -8;
	pixel_y = 8
	},
/obj/item/storage/medkit/regular,
/obj/item/reagent_containers/syringe,
/obj/structure/table/reinforced/rglass,
/obj/item/storage/medkit/brute,
/obj/item/storage/medkit/fire,
/obj/item/storage/medkit/o2,
/obj/item/storage/medkit/toxin,
/turf/open/floor/iron/white,
/area/station/security/medical)
"Cn" = (
/obj/structure/cable/multilayer/multiz,
/obj/machinery/atmospherics/pipe/smart/manifold4w/scrubbers/hidden/layer2,
/obj/machinery/atmospherics/pipe/smart/manifold4w/supply/hidden/layer4,
/obj/structure/railing,
/obj/structure/sign/poster/contraband/ultra/directional/west,
/obj/effect/turf_decal/stripes/end,
/turf/open/floor/iron/dark/diagonal,
/area/station/maintenance/department/security)
"Dt" = (
/obj/effect/turf_decal/tile/red/half/contrasted{
	dir = 4
	},
/obj/structure/closet/secure_closet/security_medic,
/obj/item/wallframe/frontier_medstation,
/turf/open/floor/iron/white,
/area/station/security/medical)
"Du" = (
/obj/effect/spawner/random/decoration/glowstick/on{
	pixel_x = -8;
	pixel_y = -2
	},
/obj/effect/turf_decal/tile/purple/diagonal_centre,
/turf/open/floor/glass/reinforced,
/area/station/maintenance/department/security)
"Em" = (
/obj/machinery/atmospherics/pipe/smart/manifold4w/scrubbers/hidden/layer2,
/obj/structure/cable,
/obj/machinery/atmospherics/pipe/smart/manifold4w/supply/hidden/layer4,
/turf/open/floor/iron/white,
/area/station/security/medical)
"Fl" = (
/obj/machinery/iv_drip,
/obj/item/radio/intercom/directional/east,
/obj/effect/turf_decal/tile/red/half/contrasted{
	dir = 4
	},
/turf/open/floor/iron/white,
/area/station/security/medical)
"Ge" = (
/obj/machinery/airalarm/directional/west,
/obj/effect/turf_decal/siding/purple{
	dir = 4
	},
/obj/effect/turf_decal/siding/dark_red{
	dir = 8
	},
/obj/effect/turf_decal/tile/purple{
	dir = 1
	},
/turf/open/floor/iron/dark/diagonal,
/area/station/maintenance/department/security)
"Ie" = (
/obj/machinery/light/directional/north,
/obj/structure/cable,
/obj/machinery/atmospherics/pipe/smart/manifold4w/scrubbers/hidden/layer2,
/obj/machinery/atmospherics/pipe/smart/manifold4w/supply/hidden/layer4,
/turf/open/floor/iron/white,
/area/station/security/medical)
"IJ" = (
/obj/structure/bodycontainer/morgue,
/obj/effect/turf_decal/tile/red/half/contrasted{
	dir = 8
	},
/turf/open/floor/iron/white,
/area/station/security/medical)
"Jo" = (
/obj/machinery/door/airlock/maintenance{
	name = "Brig Infirmary Maintenance"
	},
/obj/effect/mapping_helpers/airlock/access/all/security/general,
/obj/structure/cable,
/obj/machinery/atmospherics/pipe/smart/manifold4w/scrubbers/hidden/layer2,
/obj/machinery/atmospherics/pipe/smart/manifold4w/supply/hidden/layer4,
/turf/open/floor/plating,
/area/station/security/medical)
"Li" = (
/obj/structure/chair/x_stand,
/obj/item/clothing/sextoy/magic_wand{
	pixel_x = -16;
	pixel_y = -5
	},
/obj/item/clothing/sextoy/nipple_clamps{
	pixel_x = -9;
	pixel_y = -11
	},
/obj/effect/turf_decal/siding/dark_red{
	dir = 9
	},
/turf/open/floor/iron/dark/diagonal,
/area/station/maintenance/department/security)
"Lx" = (
/obj/structure/lattice,
/obj/effect/mapping_helpers/turn_off_lights_with_lightswitch,
/obj/structure/cable,
/turf/closed/wall,
/area/station/maintenance/department/security)
"Nf" = (
/turf/template_noop,
/area/template_noop)
"Nq" = (
/obj/structure/window/spawner/directional/south,
/obj/structure/bed,
/obj/item/bedsheet,
/obj/machinery/power/apc/auto_name/directional/east,
/obj/structure/cable,
/obj/effect/turf_decal/tile/red/half/contrasted{
	dir = 4
	},
/turf/open/floor/iron/white,
/area/station/security/medical)
"OC" = (
/turf/closed/wall/r_wall/fakewood,
/area/station/security/medical)
"Pt" = (
/obj/structure/holosign/sexsign,
/obj/effect/turf_decal/siding/dark_red{
	dir = 9
	},
/turf/open/floor/iron/dark/smooth_half{
	dir = 1
	},
/area/station/maintenance/department/security)
"PJ" = (
/obj/structure/bed,
/obj/item/bedsheet,
/obj/effect/turf_decal/tile/red/half/contrasted{
	dir = 4
	},
/obj/machinery/wall_healer/directional/east,
/turf/open/floor/iron/white,
/area/station/security/medical)
"PR" = (
/obj/structure/bed/bdsm_bed,
/obj/machinery/atmospherics/pipe/smart/manifold4w/supply/hidden/layer4,
/obj/structure/marker_beacon/violet,
/obj/item/clothing/suit/straight_jacket/latex_straight_jacket/reinforced{
	pixel_x = -8;
	pixel_y = 5
	},
/obj/item/clothing/gloves/ball_mittens_reinforced{
	pixel_x = -9;
	pixel_y = 2
	},
/obj/effect/turf_decal/siding/purple/inner_corner{
	dir = 1
	},
/obj/effect/turf_decal/tile/purple,
/turf/open/floor/iron/dark/diagonal,
/area/station/maintenance/department/security)
"Qf" = (
/obj/structure/ladder,
/obj/structure/window/reinforced/tinted/frosted{
	dir = 1
	},
/obj/structure/sign/poster/contraband/heart/directional/west,
/obj/effect/turf_decal/stripes/blue/full,
/turf/open/floor/iron/dark/smooth_half{
	dir = 1
	},
/area/station/maintenance/department/security)
"Rh" = (
/obj/structure/chair/sofa/corp/left{
	dir = 1
	},
/obj/machinery/atmospherics/components/unary/vent_pump/on/layer4{
	dir = 1
	},
/obj/effect/turf_decal/siding/dark/corner{
	dir = 1
	},
/obj/effect/turf_decal/siding/dark_red,
/turf/open/floor/iron/dark/diagonal,
/area/station/maintenance/department/security)
"Ri" = (
/obj/structure/chair/sofa/corp/right{
	dir = 8
	},
/obj/machinery/atmospherics/pipe/smart/manifold4w/supply/hidden/layer4,
/obj/structure/sign/poster/contraband/lusty_xenomorph/directional/east,
/obj/item/lustwish_discount{
	pixel_x = 2;
	pixel_y = 3
	},
/obj/effect/turf_decal/siding/dark/corner{
	dir = 1
	},
/obj/effect/turf_decal/siding/dark_red{
	dir = 4
	},
/turf/open/floor/iron/dark/diagonal,
/area/station/maintenance/department/security)
"RV" = (
/obj/machinery/atmospherics/components/unary/vent_scrubber/on/layer2{
	dir = 8
	},
/turf/open/floor/iron/white,
/area/station/security/medical)
"RZ" = (
/obj/machinery/atmospherics/pipe/smart/manifold4w/supply/hidden/layer4,
/obj/machinery/atmospherics/pipe/smart/manifold4w/scrubbers/hidden/layer2,
/obj/structure/cable/multilayer/multiz,
/turf/open/floor/plating,
/area/station/maintenance/department/security)
"Tf" = (
/obj/machinery/door/window/left/directional/south{
	name = "Brig Infirmary"
	},
/obj/machinery/atmospherics/pipe/smart/manifold4w/supply/hidden/layer4,
/obj/machinery/atmospherics/pipe/smart/manifold4w/scrubbers/hidden/layer2,
/obj/structure/cable,
/turf/open/floor/iron/white,
/area/station/security/medical)
"Tl" = (
/obj/structure/cable,
/obj/machinery/camera/directional/north{
	c_tag = "Security - Infirmary"
	},
/obj/machinery/atmospherics/pipe/smart/manifold4w/scrubbers/hidden/layer2,
/obj/machinery/atmospherics/pipe/smart/manifold4w/supply/hidden/layer4,
/turf/open/floor/iron/white,
/area/station/security/medical)
"Vo" = (
/obj/item/flashlight/glowstick/pink{
	pixel_x = 7;
	pixel_y = 0
	},
/obj/structure/cable,
/obj/machinery/atmospherics/pipe/smart/manifold4w/scrubbers/hidden/layer2,
/obj/machinery/atmospherics/pipe/smart/manifold4w/supply/hidden/layer4,
/obj/structure/marker_beacon/purple,
/obj/structure/sign/poster/contraband/fun_police/directional/east,
/obj/effect/turf_decal/siding/dark/corner{
	dir = 8
	},
/obj/effect/turf_decal/siding/dark_red{
	dir = 4
	},
/obj/effect/turf_decal/tile/purple{
	dir = 4
	},
/turf/open/floor/iron/dark/diagonal,
/area/station/maintenance/department/security)
"Wf" = (
/obj/structure/cable,
/obj/machinery/atmospherics/pipe/smart/manifold4w/scrubbers/hidden/layer2,
/obj/machinery/atmospherics/pipe/smart/manifold4w/supply/hidden/layer4,
/obj/effect/turf_decal/tile/red/half/contrasted{
	dir = 4
	},
/turf/open/floor/iron/white,
/area/station/security/medical)
"Ye" = (
/obj/machinery/door/window/right/directional/south{
	name = "Brig Infirmary"
	},
/obj/structure/cable,
/turf/open/floor/iron/white,
/area/station/security/medical)
"Yl" = (
/obj/machinery/light_switch/default_on/directional/north,
/obj/structure/cable,
/obj/machinery/atmospherics/components/unary/vent_scrubber/on/layer2{
	dir = 4
	},
/obj/machinery/light/small{
	dir = 1
	},
/obj/machinery/vending/boozeomat,
/obj/effect/turf_decal/siding/dark/corner,
/obj/effect/turf_decal/siding/dark_red{
	dir = 1
	},
/turf/open/floor/iron/dark/diagonal,
/area/station/maintenance/department/security)
"YF" = (
/obj/effect/landmark/blobstart,
/turf/open/floor/plating,
/area/station/maintenance/department/security)
"ZJ" = (
/obj/structure/lattice,
/turf/closed/wall,
/area/station/maintenance/department/security)

(1,1,1) = {"
Nf
Nf
Nf
aq
aq
aq
aq
aq
aq
Nf
Nf
"}
(2,1,1) = {"
Nf
Nf
Nf
Qf
Pt
qy
Ge
yb
aq
Nf
Nf
"}
(3,1,1) = {"
Nf
Nf
Nf
Lx
Yl
dh
pH
Bw
aq
Nf
Nf
"}
(4,1,1) = {"
aq
aq
aq
Li
aL
Du
PR
Rh
aq
Nf
Nf
"}
(5,1,1) = {"
aq
qN
Cn
Am
Vo
at
Ri
Be
aq
Nf
Nf
"}
(6,1,1) = {"
aq
aq
aq
ZJ
ZJ
ZJ
ZJ
ZJ
ZJ
Nf
Nf
"}
(7,1,1) = {"
Nf
Nf
Nf
Nf
Nf
Nf
Nf
Nf
Nf
Nf
Nf
"}

(1,1,2) = {"
Nf
Nf
Nf
Nf
OC
OC
OC
OC
wN
wN
wN
"}
(2,1,2) = {"
Nf
Nf
Nf
vT
wN
IJ
tc
bW
uJ
BW
kb
"}
(3,1,2) = {"
Nf
Nf
Nf
Nf
wN
Tl
Em
Em
Em
mF
Tf
"}
(4,1,2) = {"
Nf
Nf
Nf
Nf
wN
Ie
RV
bb
zm
ho
Ye
"}
(5,1,2) = {"
Nf
iE
RZ
uG
Jo
Wf
Dt
hZ
PJ
Fl
Nq
"}
(6,1,2) = {"
Nf
YF
xC
uG
wN
ik
ik
ik
ik
ik
ik
"}
(7,1,2) = {"
Nf
Nf
Nf
uG
Nf
Nf
Nf
Nf
Nf
Nf
Nf
"}
