//MAP CONVERTED BY dmm2tgm.py THIS HEADER COMMENT PREVENTS RECONVERSION, DO NOT REMOVE
"aq" = (
/obj/structure/bed/bdsm_bed,
/obj/machinery/atmospherics/pipe/smart/manifold4w/supply/hidden/layer4,
/obj/structure/marker_beacon/violet,
/obj/item/clothing/suit/straight_jacket/latex_straight_jacket/reinforced{
	pixel_x = -8;
	pixel_y = 5
	},
/obj/item/clothing/gloves/ball_mittens_reinforced{
	pixel_x = -9;
	pixel_y = 2
	},
/obj/effect/turf_decal/tile/purple,
/turf/open/floor/iron/dark/diagonal,
/area/station/security/execution/transfer)
"at" = (
/obj/effect/turf_decal/siding/purple/inner_corner{
	dir = 1
	},
/obj/effect/turf_decal/tile/purple,
/obj/machinery/light/small/directional/west,
/obj/machinery/atmospherics/pipe/smart/manifold4w/scrubbers/hidden/layer2,
/turf/open/floor/iron/dark/diagonal,
/area/station/security/execution/transfer)
"aL" = (
/obj/effect/turf_decal/siding/purple/inner_corner,
/obj/effect/turf_decal/siding/dark/corner{
	dir = 1
	},
/obj/structure/marker_beacon/purple,
/obj/machinery/atmospherics/components/unary/vent_scrubber/on/layer2{
	dir = 4
	},
/turf/open/floor/iron/dark/diagonal,
/area/station/security/execution/transfer)
"dh" = (
/obj/structure/holosign/sexsign,
/obj/effect/turf_decal/siding/dark_red{
	dir = 9
	},
/turf/open/floor/iron/dark/smooth_half{
	dir = 1
	},
/area/station/security/execution/transfer)
"gH" = (
/obj/machinery/atmospherics/pipe/smart/manifold4w/scrubbers/hidden/layer2,
/obj/structure/chair/milking_machine,
/obj/item/clothing/sextoy/vibroring{
	pixel_x = 9;
	pixel_y = -7
	},
/obj/effect/turf_decal/siding/dark_red{
	dir = 5
	},
/turf/open/floor/iron/dark/diagonal,
/area/station/security/execution/transfer)
"pH" = (
/obj/structure/chair/pillow_small,
/obj/item/clothing/sextoy/dildo{
	pixel_x = 3;
	pixel_y = 1
	},
/obj/item/reagent_containers/cup/glass/bottle/femcum_whiskey{
	pixel_x = 11;
	pixel_y = -2
	},
/obj/effect/turf_decal/siding/dark_red{
	dir = 4
	},
/obj/effect/turf_decal/tile/purple,
/obj/effect/turf_decal/tile/purple,
/obj/effect/turf_decal/tile/purple,
/turf/open/floor/iron/dark/diagonal,
/area/station/security/execution/transfer)
"qy" = (
/obj/effect/turf_decal/siding/purple{
	dir = 8
	},
/obj/effect/turf_decal/tile/purple,
/turf/open/floor/iron/dark/diagonal,
/area/station/security/execution/transfer)
"qN" = (
/obj/structure/chair/sofa/corp/corner{
	dir = 8
	},
/obj/structure/sign/poster/contraband/double_rainbow/directional/south,
/obj/effect/turf_decal/siding/dark_red{
	dir = 6
	},
/obj/effect/turf_decal/tile/purple,
/turf/open/floor/iron/dark/diagonal,
/area/station/security/execution/transfer)
"xN" = (
/obj/effect/turf_decal/siding/purple/inner_corner,
/obj/effect/turf_decal/tile/purple{
	dir = 1
	},
/obj/structure/sign/poster/contraband/ultra/directional/east,
/turf/open/floor/iron/dark/diagonal,
/area/station/security/execution/transfer)
"yb" = (
/obj/effect/turf_decal/siding/dark/corner,
/obj/effect/turf_decal/siding/dark_red{
	dir = 5
	},
/obj/effect/turf_decal/tile/purple{
	dir = 1
	},
/turf/open/floor/iron/dark/diagonal,
/area/station/security/execution/transfer)
"yo" = (
/obj/structure/chair/sofa/corp/right{
	dir = 8
	},
/obj/structure/sign/poster/contraband/lusty_xenomorph/directional/east,
/obj/item/lustwish_discount{
	pixel_x = 2;
	pixel_y = 3
	},
/obj/effect/turf_decal/siding/dark_red{
	dir = 4
	},
/obj/effect/turf_decal/tile/purple,
/turf/open/floor/iron/dark/diagonal,
/area/station/security/execution/transfer)
"Am" = (
/obj/effect/turf_decal/siding/dark_red{
	dir = 1
	},
/obj/effect/turf_decal/siding/purple,
/obj/structure/chair/sofa/corp/left,
/turf/open/floor/iron/dark/diagonal,
/area/station/security/execution/transfer)
"Ba" = (
/turf/closed/wall/r_wall,
/area/station/security/execution/transfer)
"Be" = (
/obj/effect/turf_decal/siding/dark_red{
	dir = 10
	},
/obj/effect/turf_decal/tile/purple,
/obj/structure/marker_beacon/purple,
/obj/structure/chair/pillow_small,
/obj/item/clothing/sextoy/fleshlight{
	pixel_x = 6;
	pixel_y = -7
	},
/obj/item/reagent_containers/cup/glass/bottle/cum_rum{
	pixel_x = -14;
	pixel_y = -5
	},
/obj/effect/turf_decal/tile/purple,
/turf/open/floor/iron/dark/diagonal,
/area/station/security/execution/transfer)
"Bw" = (
/obj/structure/chair/sofa/corp/left{
	dir = 1
	},
/obj/machinery/atmospherics/components/unary/vent_pump/on/layer4{
	dir = 1
	},
/obj/effect/turf_decal/siding/dark/corner{
	dir = 1
	},
/obj/effect/turf_decal/siding/dark_red,
/obj/effect/turf_decal/tile/purple,
/turf/open/floor/iron/dark/diagonal,
/area/station/security/execution/transfer)
"Cn" = (
/obj/structure/chair/x_stand,
/obj/item/clothing/sextoy/magic_wand{
	pixel_x = -16;
	pixel_y = -5
	},
/obj/item/clothing/sextoy/nipple_clamps{
	pixel_x = -9;
	pixel_y = -11
	},
/obj/effect/turf_decal/siding/dark/corner{
	dir = 8
	},
/turf/open/floor/iron/dark/diagonal,
/area/station/security/execution/transfer)
"Du" = (
/obj/item/flashlight/glowstick/pink{
	pixel_x = 7;
	pixel_y = 0
	},
/obj/structure/marker_beacon/purple,
/obj/structure/sign/poster/contraband/fun_police/directional/east,
/obj/effect/turf_decal/siding/dark_red{
	dir = 4
	},
/obj/effect/turf_decal/tile/purple,
/turf/open/floor/iron/dark/diagonal,
/area/station/security/execution/transfer)
"Ge" = (
/obj/structure/ladder,
/obj/structure/sign/poster/contraband/heart/directional/west,
/obj/effect/turf_decal/stripes/blue/full,
/turf/open/floor/iron/dark/smooth_half{
	dir = 1
	},
/area/station/security/execution/transfer)
"Li" = (
/obj/effect/turf_decal/siding/dark_red{
	dir = 1
	},
/obj/effect/turf_decal/siding/dark/corner,
/obj/effect/turf_decal/siding/purple/inner_corner{
	dir = 1
	},
/obj/structure/chair/sofa/corp/right,
/turf/open/floor/iron/dark/diagonal,
/area/station/security/execution/transfer)
"Lx" = (
/obj/item/flashlight/glowstick/pink{
	pixel_x = -7;
	pixel_y = -5
	},
/obj/effect/turf_decal/tile/purple/diagonal_centre,
/turf/open/floor/glass/reinforced,
/area/station/security/execution/transfer)
"Nf" = (
/turf/template_noop,
/area/template_noop)
"Pt" = (
/obj/machinery/vending/dorms,
/obj/item/toy/plush/toaste_plushy{
	pixel_x = 3;
	pixel_y = 20
	},
/obj/item/clothing/mask/leatherwhip{
	pixel_x = -7;
	pixel_y = 22
	},
/obj/item/clothing/head/domina_cap{
	pixel_x = 6;
	pixel_y = 31
	},
/obj/structure/marker_beacon/purple,
/obj/structure/sign/poster/contraband/busty_backdoor_xeno_babes_6/directional/west,
/obj/structure/sign/poster/contraband/crocin_pool/directional/south,
/obj/effect/turf_decal/siding/dark/corner{
	dir = 4
	},
/obj/effect/turf_decal/siding/dark_red{
	dir = 10
	},
/turf/open/floor/iron/dark/diagonal,
/area/station/security/execution/transfer)
"PR" = (
/obj/structure/falsewall/reinforced,
/obj/machinery/atmospherics/pipe/smart/manifold4w/scrubbers/hidden/layer2,
/obj/machinery/atmospherics/pipe/smart/manifold4w/supply/hidden/layer4,
/turf/open/floor/plating,
/area/station/security/execution/transfer)
"Qf" = (
/obj/machinery/airalarm/directional/west,
/obj/effect/turf_decal/siding/purple{
	dir = 4
	},
/obj/effect/turf_decal/siding/dark_red{
	dir = 8
	},
/obj/effect/turf_decal/tile/purple{
	dir = 1
	},
/turf/open/floor/iron/dark/diagonal,
/area/station/security/execution/transfer)
"Rh" = (
/obj/machinery/vending/boozeomat,
/turf/open/floor/iron/dark/smooth_half{
	dir = 1
	},
/area/station/security/execution/transfer)
"Ri" = (
/obj/effect/turf_decal/siding/dark_red{
	dir = 8
	},
/obj/machinery/atmospherics/pipe/smart/manifold4w/supply/hidden/layer4,
/obj/machinery/atmospherics/pipe/smart/manifold4w/scrubbers/hidden/layer2,
/obj/effect/turf_decal/tile/purple,
/turf/open/floor/iron/dark/diagonal,
/area/station/security/execution/transfer)
"Tt" = (
/obj/effect/spawner/random/decoration/glowstick/on{
	pixel_x = 3;
	pixel_y = 8
	},
/obj/effect/turf_decal/siding/dark/corner,
/obj/effect/turf_decal/siding/dark_red{
	dir = 8
	},
/obj/machinery/light/small/directional/west,
/obj/structure/marker_beacon/purple,
/obj/effect/turf_decal/tile/purple{
	dir = 1
	},
/turf/open/floor/iron/dark/diagonal,
/area/station/security/execution/transfer)
"Vo" = (
/obj/effect/turf_decal/tile/purple/diagonal_centre,
/obj/machinery/atmospherics/pipe/smart/manifold4w/scrubbers/hidden/layer2,
/turf/open/floor/glass/reinforced,
/area/station/security/execution/transfer)
"Yl" = (
/obj/effect/turf_decal/siding/purple{
	dir = 1
	},
/obj/effect/turf_decal/siding/dark_red,
/obj/effect/turf_decal/tile/purple,
/turf/open/floor/iron/dark/diagonal,
/area/station/security/execution/transfer)
"ZJ" = (
/obj/effect/spawner/random/decoration/glowstick/on{
	pixel_x = -8;
	pixel_y = -2
	},
/obj/effect/turf_decal/siding/dark/corner{
	dir = 1
	},
/obj/effect/turf_decal/tile/purple,
/turf/open/floor/iron/dark/diagonal,
/area/station/security/execution/transfer)

(1,1,1) = {"
Ba
Ba
Ba
Ba
Ba
Ba
Ba
Nf
Nf
Nf
"}
(2,1,1) = {"
Ba
Ge
dh
Tt
Qf
Pt
Ba
Nf
Nf
Nf
"}
(3,1,1) = {"
Ba
Rh
yb
xN
Lx
Yl
Ba
Nf
Nf
Nf
"}
(4,1,1) = {"
Ba
Ba
Ba
Ba
Li
aL
Ba
PR
Ba
Ba
"}
(5,1,1) = {"
Nf
Nf
Nf
Ba
Am
Vo
at
Ri
Be
Ba
"}
(6,1,1) = {"
Nf
Nf
Nf
Ba
Cn
qy
ZJ
aq
Bw
Ba
"}
(7,1,1) = {"
Nf
Nf
Nf
Ba
gH
Du
pH
yo
qN
Ba
"}
(8,1,1) = {"
Nf
Nf
Nf
Ba
Ba
Ba
Ba
Ba
Ba
Ba
"}
