//MAP CONVERTED BY dmm2tgm.py THIS HEADER COMMENT PREVENTS RECONVERSION, DO NOT REMOVE
"a" = (
/obj/structure/bodycontainer/morgue,
/obj/effect/turf_decal/trimline/blue/filled/line{
	dir = 9
	},
/obj/structure/sign/poster/official/cleanliness/directional/north,
/turf/open/floor/iron/white,
/area/station/security/medical)
"b" = (
/turf/closed/wall/r_wall/fakewood,
/area/station/security/medical)
"c" = (
/obj/machinery/light/small/directional/north{
	dir = 8
	},
/obj/structure/table/reinforced,
/obj/machinery/computer/records/medical/laptop{
	dir = 4;
	pixel_x = 4;
	pixel_y = 3
	},
/obj/effect/turf_decal/trimline/blue/filled/line{
	dir = 8
	},
/obj/effect/turf_decal/trimline/blue/filled/corner{
	dir = 4
	},
/obj/machinery/atmospherics/components/unary/vent_scrubber/on/layer2{
	dir = 4
	},
/obj/machinery/firealarm/directional/west,
/turf/open/floor/iron/white,
/area/station/security/medical)
"f" = (
/turf/closed/wall,
/area/station/security/medical)
"i" = (
/obj/structure/window/reinforced/spawner/directional/south,
/obj/structure/table/reinforced,
/obj/effect/turf_decal/trimline/blue/filled/line{
	dir = 10
	},
/obj/item/paper_bin{
	pixel_x = -6;
	pixel_y = 5
	},
/obj/item/pen{
	pixel_x = -6;
	pixel_y = 6
	},
/obj/item/radio/intercom/directional/west,
/obj/item/reagent_containers/cup/glass/mug/nanotrasen{
	pixel_x = 8;
	pixel_y = 9
	},
/turf/open/floor/iron/white,
/area/station/security/medical)
"m" = (
/obj/machinery/stasis,
/obj/effect/turf_decal/trimline/blue/filled/line{
	dir = 4
	},
/obj/machinery/defibrillator_mount/directional/east,
/obj/effect/turf_decal/trimline/blue/filled/corner{
	dir = 1
	},
/obj/item/bedsheet/medical,
/obj/machinery/iv_drip,
/turf/open/floor/iron/white,
/area/station/security/medical)
"n" = (
/obj/machinery/atmospherics/pipe/smart/manifold4w/scrubbers/hidden/layer2,
/obj/structure/cable,
/obj/machinery/atmospherics/pipe/smart/manifold4w/supply/hidden/layer4,
/obj/effect/turf_decal/trimline/blue/filled/warning,
/turf/open/floor/iron/white,
/area/station/security/medical)
"o" = (
/turf/closed/wall/r_wall,
/area/station/security/medical)
"r" = (
/obj/structure/cable,
/obj/machinery/camera/directional/north{
	c_tag = "Security - Infirmary"
	},
/obj/machinery/atmospherics/pipe/smart/manifold4w/scrubbers/hidden/layer2,
/obj/machinery/atmospherics/pipe/smart/manifold4w/supply/hidden/layer4,
/obj/effect/turf_decal/trimline/blue/filled/line{
	dir = 1
	},
/obj/structure/sink/directional/south,
/turf/open/floor/iron/white,
/area/station/security/medical)
"t" = (
/obj/structure/cable,
/obj/machinery/atmospherics/pipe/smart/manifold4w/scrubbers/hidden/layer2,
/obj/machinery/atmospherics/pipe/smart/manifold4w/supply/hidden/layer4,
/obj/effect/turf_decal/trimline/blue/filled/line{
	dir = 5
	},
/turf/open/floor/iron/white,
/area/station/security/medical)
"v" = (
/obj/structure/window/reinforced/spawner/directional/north{
	pixel_x = 0;
	pixel_y = 3
	},
/obj/structure/table/reinforced/rglass,
/obj/effect/spawner/surgery_tray/full,
/obj/effect/turf_decal/trimline/blue/filled/line{
	dir = 1
	},
/obj/effect/turf_decal/trimline/blue/filled/corner{
	dir = 8
	},
/obj/machinery/atmospherics/components/unary/vent_pump/on/layer4{
	dir = 8
	},
/turf/open/floor/iron/white,
/area/station/security/medical)
"w" = (
/obj/machinery/atmospherics/pipe/smart/manifold4w/scrubbers/hidden/layer2,
/obj/structure/cable,
/obj/machinery/atmospherics/pipe/smart/manifold4w/supply/hidden/layer4,
/obj/effect/turf_decal/trimline/blue/filled/line{
	dir = 6
	},
/turf/open/floor/iron/white,
/area/station/security/medical)
"x" = (
/obj/machinery/light/directional/north,
/obj/structure/cable,
/obj/machinery/atmospherics/pipe/smart/manifold4w/scrubbers/hidden/layer2,
/obj/machinery/atmospherics/pipe/smart/manifold4w/supply/hidden/layer4,
/obj/effect/turf_decal/trimline/blue/filled/line{
	dir = 1
	},
/turf/open/floor/iron/white,
/area/station/security/medical)
"z" = (
/obj/structure/extinguisher_cabinet/directional/west,
/obj/structure/window/reinforced/spawner/directional/north{
	pixel_x = 0;
	pixel_y = 3
	},
/obj/structure/table/reinforced,
/obj/effect/turf_decal/trimline/blue/filled/line{
	dir = 9
	},
/obj/item/reagent_containers/cup/bottle/epinephrine{
	pixel_x = -8;
	pixel_y = 4
	},
/obj/item/reagent_containers/cup/bottle/multiver{
	pixel_x = -3;
	pixel_y = 4
	},
/obj/item/reagent_containers/syringe{
	pixel_x = -8;
	pixel_y = -8
	},
/obj/item/reagent_containers/spray/cleaner{
	pixel_x = 7;
	pixel_y = 4
	},
/turf/open/floor/iron/white,
/area/station/security/medical)
"D" = (
/obj/machinery/power/apc/auto_name/directional/east,
/obj/structure/cable,
/obj/structure/window/reinforced/spawner/directional/south,
/obj/machinery/computer/crew{
	dir = 8
	},
/obj/effect/turf_decal/trimline/blue/filled/line{
	dir = 6
	},
/turf/open/floor/iron/white,
/area/station/security/medical)
"F" = (
/obj/structure/rack/shelf,
/obj/effect/turf_decal/trimline/blue/filled/line,
/obj/machinery/atmospherics/components/unary/vent_scrubber/on/layer2{
	dir = 8
	},
/obj/item/emergency_bed,
/obj/item/emergency_bed,
/obj/item/storage/medkit/regular,
/turf/open/floor/iron/white,
/area/station/security/medical)
"H" = (
/obj/structure/table/reinforced,
/obj/effect/turf_decal/trimline/blue/filled/line{
	dir = 8
	},
/obj/item/folder/white{
	pixel_x = -6;
	pixel_y = 3
	},
/obj/effect/turf_decal/trimline/blue/filled/corner,
/obj/structure/sign/poster/official/moth_epi/directional/west,
/obj/item/folder/red{
	pixel_x = -1;
	pixel_y = 3
	},
/obj/item/healthanalyzer{
	pixel_x = -6;
	pixel_y = -10
	},
/obj/item/clothing/gloves/latex{
	pixel_x = 0;
	pixel_y = 17
	},
/obj/item/clothing/mask/surgical{
	pixel_x = -1;
	pixel_y = 16
	},
/turf/open/floor/iron/white,
/area/station/security/medical)
"K" = (
/obj/machinery/atmospherics/pipe/smart/manifold4w/supply/hidden/layer4,
/obj/machinery/atmospherics/pipe/smart/manifold4w/scrubbers/hidden/layer2,
/obj/structure/cable,
/obj/machinery/door/window/brigdoor/right/directional/south{
	req_access = list("security");
	name = "Security Infirmary";
	dir = 2
	},
/obj/effect/turf_decal/trimline/blue/filled/warning,
/obj/effect/turf_decal/trimline/blue/filled/corner{
	dir = 4
	},
/obj/machinery/door/firedoor/border_only{
	pixel_x = 0;
	pixel_y = -1
	},
/turf/open/floor/iron/white,
/area/station/security/medical)
"N" = (
/obj/effect/turf_decal/trimline/blue/filled/line{
	dir = 9
	},
/turf/open/floor/iron/white,
/area/station/security/medical)
"O" = (
/obj/machinery/atmospherics/pipe/smart/manifold4w/scrubbers/hidden/layer2,
/obj/structure/cable,
/obj/machinery/atmospherics/pipe/smart/manifold4w/supply/hidden/layer4,
/obj/effect/turf_decal/trimline/blue/filled/warning{
	dir = 1
	},
/obj/machinery/door/window/brigdoor/right/directional/south{
	req_access = list("security");
	name = "Security Infirmary";
	dir = 1;
	pixel_x = 0;
	pixel_y = 3
	},
/obj/effect/turf_decal/trimline/blue/filled/corner,
/turf/open/floor/iron/white,
/area/station/security/medical)
"R" = (
/obj/machinery/atmospherics/pipe/smart/manifold4w/supply/hidden/layer4,
/obj/machinery/atmospherics/pipe/smart/manifold4w/scrubbers/hidden/layer2,
/obj/structure/cable,
/obj/effect/turf_decal/trimline/blue/filled/line{
	dir = 5
	},
/turf/open/floor/iron/white,
/area/station/security/medical)
"S" = (
/obj/structure/table/optable,
/obj/effect/turf_decal/trimline/blue/filled/line{
	dir = 4
	},
/obj/machinery/wall_healer/directional/east,
/obj/effect/turf_decal/trimline/blue/filled/corner{
	dir = 8
	},
/turf/open/floor/iron/white,
/area/station/security/medical)
"T" = (
/obj/structure/bodycontainer/morgue,
/obj/effect/turf_decal/trimline/blue/filled/line{
	dir = 10
	},
/turf/open/floor/iron/white,
/area/station/security/medical)
"U" = (
/obj/structure/cable,
/obj/structure/window/reinforced/spawner/directional/south,
/obj/structure/chair/office/light{
	dir = 4
	},
/obj/effect/turf_decal/trimline/blue/filled/line,
/obj/effect/turf_decal/trimline/blue/filled/corner{
	dir = 1
	},
/obj/effect/landmark/start/security_medic,
/turf/open/floor/iron/white,
/area/station/security/medical)
"V" = (
/obj/machinery/door/airlock/maintenance{
	name = "Brig Infirmary Maintenance"
	},
/obj/effect/mapping_helpers/airlock/access/all/security/general,
/obj/structure/cable,
/obj/machinery/atmospherics/pipe/smart/manifold4w/scrubbers/hidden/layer2,
/obj/machinery/atmospherics/pipe/smart/manifold4w/supply/hidden/layer4,
/turf/open/floor/plating,
/area/station/security/medical)
"W" = (
/obj/machinery/airalarm/directional/east,
/obj/structure/window/reinforced/spawner/directional/north{
	pixel_x = 0;
	pixel_y = 3
	},
/obj/machinery/computer/operating,
/obj/effect/turf_decal/trimline/blue/filled/line{
	dir = 5
	},
/turf/open/floor/iron/white,
/area/station/security/medical)
"X" = (
/obj/structure/closet/secure_closet/security_medic,
/obj/effect/turf_decal/trimline/blue/filled/line{
	dir = 6
	},
/obj/machinery/atmospherics/components/unary/vent_pump/on/layer4{
	dir = 1
	},
/turf/open/floor/iron/white,
/area/station/security/medical)
"Z" = (
/obj/effect/turf_decal/trimline/blue/filled/line{
	dir = 10
	},
/obj/effect/landmark/start/security_medic,
/turf/open/floor/iron/white,
/area/station/security/medical)

(1,1,1) = {"
b
b
b
b
o
o
o
"}
(2,1,1) = {"
o
a
T
z
H
c
i
"}
(3,1,1) = {"
o
r
n
O
w
R
K
"}
(4,1,1) = {"
o
x
F
v
Z
N
U
"}
(5,1,1) = {"
V
t
X
W
S
m
D
"}
(6,1,1) = {"
o
f
f
f
f
f
f
"}
