//MAP CONVERTED BY dmm2tgm.py THIS HEADER COMMENT PREVENTS RECONVERSION, DO NOT REMOVE
"aq" = (
/turf/closed/wall,
/area/station/maintenance/department/security)
"at" = (
/obj/structure/chair/pillow_small,
/obj/item/clothing/sextoy/dildo{
	pixel_x = 3;
	pixel_y = 1
	},
/obj/machinery/atmospherics/pipe/smart/manifold4w/supply/hidden/layer4,
/obj/item/reagent_containers/cup/glass/bottle/femcum_whiskey{
	pixel_x = 11;
	pixel_y = -2
	},
/obj/effect/turf_decal/siding/purple{
	dir = 8
	},
/obj/effect/turf_decal/siding/dark_red{
	dir = 4
	},
/obj/effect/turf_decal/tile/purple,
/turf/open/floor/iron/dark/diagonal,
/area/station/maintenance/department/security)
"aL" = (
/obj/machinery/atmospherics/pipe/smart/manifold4w/scrubbers/hidden/layer2,
/obj/effect/turf_decal/siding/purple,
/obj/effect/turf_decal/siding/dark_red/corner{
	dir = 1
	},
/obj/effect/turf_decal/tile/purple{
	dir = 1
	},
/turf/open/floor/iron/dark/diagonal,
/area/station/maintenance/department/security)
"dh" = (
/obj/effect/turf_decal/siding/purple/inner_corner,
/obj/effect/turf_decal/tile/purple{
	dir = 1
	},
/turf/open/floor/iron/dark/diagonal,
/area/station/maintenance/department/security)
"gH" = (
/obj/structure/window/reinforced/tinted/frosted/spawner/directional/west,
/obj/effect/spawner/random/trash/graffiti,
/turf/open/floor/iron/dark/smooth_half{
	dir = 1
	},
/area/station/maintenance/department/security)
"pH" = (
/obj/item/flashlight/glowstick/pink{
	pixel_x = -7;
	pixel_y = -5
	},
/obj/effect/turf_decal/tile/purple/diagonal_centre,
/turf/open/floor/glass/reinforced,
/area/station/maintenance/department/security)
"qy" = (
/obj/effect/spawner/random/decoration/glowstick/on{
	pixel_x = 3;
	pixel_y = 8
	},
/obj/effect/turf_decal/siding/dark/corner,
/obj/effect/turf_decal/siding/dark_red{
	dir = 8
	},
/obj/machinery/light_switch/default_on/directional/west,
/obj/machinery/light/small/directional/west,
/turf/open/floor/iron/dark/diagonal,
/area/station/maintenance/department/security)
"qN" = (
/obj/machinery/atmospherics/pipe/multiz/scrubbers/visible/layer2,
/obj/machinery/atmospherics/pipe/multiz/supply/visible/layer4,
/obj/structure/sign/poster/contraband/missing_gloves/directional/east,
/obj/effect/turf_decal/stripes/end{
	dir = 1
	},
/obj/item/toy/plush/rouny{
	pixel_x = 10;
	pixel_y = 10
	},
/turf/open/floor/iron/dark/diagonal,
/area/station/maintenance/department/security)
"yb" = (
/obj/machinery/vending/dorms,
/obj/item/toy/plush/toaste_plushy{
	pixel_x = 3;
	pixel_y = 20
	},
/obj/item/clothing/mask/leatherwhip{
	pixel_x = -7;
	pixel_y = 22
	},
/obj/item/clothing/head/domina_cap{
	pixel_x = 6;
	pixel_y = 31
	},
/obj/structure/marker_beacon/purple,
/obj/structure/sign/poster/contraband/busty_backdoor_xeno_babes_6/directional/west,
/obj/structure/sign/poster/contraband/crocin_pool/directional/south,
/obj/effect/turf_decal/siding/dark/corner{
	dir = 4
	},
/obj/effect/turf_decal/siding/dark_red{
	dir = 10
	},
/turf/open/floor/iron/dark/diagonal,
/area/station/maintenance/department/security)
"Am" = (
/obj/machinery/atmospherics/pipe/smart/manifold4w/scrubbers/hidden/layer2,
/obj/machinery/atmospherics/pipe/smart/manifold4w/supply/hidden/layer4,
/obj/structure/chair/milking_machine,
/obj/item/clothing/sextoy/vibroring{
	pixel_x = 9;
	pixel_y = -7
	},
/obj/effect/turf_decal/siding/dark_red{
	dir = 5
	},
/turf/open/floor/iron/dark/diagonal,
/area/station/maintenance/department/security)
"Ba" = (
/obj/structure/window/reinforced/tinted/frosted/spawner/directional/west,
/obj/structure/railing,
/obj/effect/spawner/random/trash/graffiti,
/turf/open/floor/iron/dark/smooth_half{
	dir = 1
	},
/area/station/maintenance/department/security)
"Be" = (
/obj/structure/chair/sofa/corp/corner{
	dir = 8
	},
/obj/structure/sign/poster/contraband/double_rainbow/directional/south,
/obj/effect/turf_decal/siding/dark_red{
	dir = 6
	},
/turf/open/floor/iron/dark/diagonal,
/area/station/maintenance/department/security)
"Bw" = (
/obj/structure/chair/pillow_small,
/obj/item/clothing/sextoy/fleshlight{
	pixel_x = 6;
	pixel_y = -7
	},
/obj/item/reagent_containers/cup/glass/bottle/cum_rum{
	pixel_x = -14;
	pixel_y = -5
	},
/obj/effect/turf_decal/siding/purple{
	dir = 1
	},
/obj/effect/turf_decal/siding/dark_red,
/obj/effect/turf_decal/tile/purple,
/turf/open/floor/iron/dark/diagonal,
/area/station/maintenance/department/security)
"Cn" = (
/obj/structure/cable/multilayer/multiz,
/obj/machinery/atmospherics/pipe/smart/manifold4w/scrubbers/hidden/layer2,
/obj/machinery/atmospherics/pipe/smart/manifold4w/supply/hidden/layer4,
/obj/structure/railing,
/obj/effect/turf_decal/stripes/end,
/obj/structure/sign/poster/contraband/ultra/directional/east,
/turf/open/floor/iron/dark/diagonal,
/area/station/maintenance/department/security)
"Du" = (
/obj/effect/spawner/random/decoration/glowstick/on{
	pixel_x = -8;
	pixel_y = -2
	},
/obj/effect/turf_decal/tile/purple/diagonal_centre,
/turf/open/floor/glass/reinforced,
/area/station/maintenance/department/security)
"Ge" = (
/obj/machinery/airalarm/directional/west,
/obj/effect/turf_decal/siding/purple{
	dir = 4
	},
/obj/effect/turf_decal/siding/dark_red{
	dir = 8
	},
/obj/effect/turf_decal/tile/purple{
	dir = 1
	},
/turf/open/floor/iron/dark/diagonal,
/area/station/maintenance/department/security)
"Li" = (
/obj/structure/chair/x_stand,
/obj/item/clothing/sextoy/magic_wand{
	pixel_x = -16;
	pixel_y = -5
	},
/obj/item/clothing/sextoy/nipple_clamps{
	pixel_x = -9;
	pixel_y = -11
	},
/obj/effect/turf_decal/siding/dark_red{
	dir = 9
	},
/turf/open/floor/iron/dark/diagonal,
/area/station/maintenance/department/security)
"Lx" = (
/obj/structure/window/reinforced/tinted/frosted/spawner/directional/north,
/obj/machinery/vending/boozeomat,
/turf/open/floor/iron/dark/smooth_half{
	dir = 1
	},
/area/station/maintenance/department/security)
"Nf" = (
/turf/template_noop,
/area/template_noop)
"Pt" = (
/obj/structure/holosign/sexsign,
/obj/effect/turf_decal/siding/dark_red{
	dir = 9
	},
/turf/open/floor/iron/dark/smooth_half{
	dir = 1
	},
/area/station/maintenance/department/security)
"PR" = (
/obj/structure/bed/bdsm_bed,
/obj/machinery/atmospherics/pipe/smart/manifold4w/supply/hidden/layer4,
/obj/structure/marker_beacon/violet,
/obj/item/clothing/suit/straight_jacket/latex_straight_jacket/reinforced{
	pixel_x = -8;
	pixel_y = 5
	},
/obj/item/clothing/gloves/ball_mittens_reinforced{
	pixel_x = -9;
	pixel_y = 2
	},
/obj/effect/turf_decal/siding/purple/inner_corner{
	dir = 1
	},
/obj/effect/turf_decal/tile/purple,
/turf/open/floor/iron/dark/diagonal,
/area/station/maintenance/department/security)
"Qf" = (
/obj/structure/ladder,
/obj/structure/sign/poster/contraband/heart/directional/west,
/obj/effect/turf_decal/stripes/blue/full,
/obj/structure/window/reinforced/tinted/frosted/spawner/directional/north,
/turf/open/floor/iron/dark/smooth_half{
	dir = 1
	},
/area/station/maintenance/department/security)
"Rh" = (
/obj/structure/chair/sofa/corp/left{
	dir = 1
	},
/obj/machinery/atmospherics/components/unary/vent_pump/on/layer4{
	dir = 1
	},
/obj/effect/turf_decal/siding/dark/corner{
	dir = 1
	},
/obj/effect/turf_decal/siding/dark_red,
/turf/open/floor/iron/dark/diagonal,
/area/station/maintenance/department/security)
"Ri" = (
/obj/structure/chair/sofa/corp/right{
	dir = 8
	},
/obj/machinery/atmospherics/pipe/smart/manifold4w/supply/hidden/layer4,
/obj/structure/sign/poster/contraband/lusty_xenomorph/directional/east,
/obj/item/lustwish_discount{
	pixel_x = 2;
	pixel_y = 3
	},
/obj/effect/turf_decal/siding/dark/corner{
	dir = 1
	},
/obj/effect/turf_decal/siding/dark_red{
	dir = 4
	},
/turf/open/floor/iron/dark/diagonal,
/area/station/maintenance/department/security)
"Vo" = (
/obj/item/flashlight/glowstick/pink{
	pixel_x = 7;
	pixel_y = 0
	},
/obj/machinery/atmospherics/pipe/smart/manifold4w/scrubbers/hidden/layer2,
/obj/machinery/atmospherics/pipe/smart/manifold4w/supply/hidden/layer4,
/obj/structure/marker_beacon/purple,
/obj/structure/sign/poster/contraband/fun_police/directional/east,
/obj/effect/turf_decal/siding/dark/corner{
	dir = 8
	},
/obj/effect/turf_decal/siding/dark_red{
	dir = 4
	},
/obj/effect/turf_decal/tile/purple{
	dir = 4
	},
/turf/open/floor/iron/dark/diagonal,
/area/station/maintenance/department/security)
"Yl" = (
/obj/machinery/atmospherics/components/unary/vent_scrubber/on/layer2{
	dir = 4
	},
/obj/effect/turf_decal/siding/dark/corner,
/obj/effect/turf_decal/siding/dark_red{
	dir = 1
	},
/turf/open/floor/iron/dark/diagonal,
/area/station/maintenance/department/security)
"ZJ" = (
/obj/effect/mapping_helpers/turn_off_lights_with_lightswitch,
/turf/closed/wall,
/area/station/maintenance/department/security)

(1,1,1) = {"
Nf
Nf
Nf
aq
aq
ZJ
aq
aq
aq
"}
(2,1,1) = {"
Nf
Nf
Nf
Qf
Pt
qy
Ge
yb
aq
"}
(3,1,1) = {"
Nf
Nf
Nf
Lx
Yl
dh
pH
Bw
aq
"}
(4,1,1) = {"
aq
gH
Ba
Li
aL
Du
PR
Rh
aq
"}
(5,1,1) = {"
aq
qN
Cn
Am
Vo
at
Ri
Be
aq
"}
(6,1,1) = {"
aq
aq
aq
aq
aq
aq
aq
aq
aq
"}
