//MAP CONVERTED BY dmm2tgm.py THIS HEADER COMMENT PREVENTS RECONVERSION, DO NOT REMOVE
"a" = (
/obj/effect/spawner/structure/window/reinforced,
/obj/machinery/door/poddoor/shutters/preopen{
	id = "nt_rep_priv"
	},
/turf/open/floor/plating,
/area/station/command/heads_quarters/nt_rep)
"b" = (
/obj/structure/chair/comfy/brown,
/obj/effect/landmark/start/nanotrasen_consultant,
/turf/open/floor/carpet/executive,
/area/station/command/heads_quarters/nt_rep)
"c" = (
/obj/structure/sign/flag/nanotrasen,
/turf/closed/wall,
/area/station/command/heads_quarters/nt_rep)
"d" = (
/obj/structure/filingcabinet,
/obj/structure/filingcabinet/medical{
	pixel_x = -10
	},
/obj/structure/filingcabinet/security{
	pixel_x = 10
	},
/obj/effect/turf_decal/siding/dark,
/obj/effect/turf_decal/siding/wood{
	dir = 4
	},
/obj/machinery/requests_console/directional/north{
	name = "Nanotrasen Consultant's Requests Console";
	department = "Nanotrasen Consultant's Desk"
	},
/turf/open/floor/carpet/green,
/area/station/command/heads_quarters/nt_rep)
"e" = (
/obj/structure/sign/clock/directional/north,
/obj/structure/closet/secure_closet/nanotrasen_consultant,
/turf/open/floor/carpet/executive,
/area/station/command/heads_quarters/nt_rep)
"f" = (
/turf/closed/wall,
/area/station/cargo/sorting)
"h" = (
/obj/structure/table/reinforced/titaniumglass,
/obj/item/clipboard{
	pixel_y = 4;
	pixel_x = -3
	},
/obj/item/folder/blue{
	pixel_y = 1
	},
/obj/item/reagent_containers/cup/glass/mug/nanotrasen{
	pixel_x = 12;
	pixel_y = 12
	},
/obj/item/sign/flag/nanotrasen,
/turf/open/floor/carpet/executive,
/area/station/command/heads_quarters/nt_rep)
"i" = (
/obj/machinery/atmospherics/components/unary/vent_pump/on/layer4{
	dir = 1
	},
/obj/structure/table/wood,
/obj/item/folder/yellow,
/obj/item/folder/white{
	pixel_y = 3
	},
/obj/item/folder/red{
	pixel_y = 6
	},
/obj/item/folder/blue{
	pixel_y = 9
	},
/turf/open/floor/wood,
/area/station/command/heads_quarters/nt_rep)
"k" = (
/obj/structure/table/wood,
/obj/item/paper_bin{
	pixel_y = 4
	},
/obj/item/pen/fountain,
/obj/item/stamp/granted{
	pixel_x = -6
	},
/obj/item/stamp/denied{
	pixel_x = 6
	},
/turf/open/floor/wood,
/area/station/command/heads_quarters/nt_rep)
"n" = (
/obj/machinery/atmospherics/pipe/smart/manifold4w/supply/hidden/layer4,
/obj/machinery/atmospherics/pipe/smart/manifold4w/scrubbers/hidden/layer2,
/obj/structure/cable,
/obj/structure/chair/comfy/beige,
/obj/effect/landmark/start/nanotrasen_crew_trainer,
/turf/open/floor/wood,
/area/station/command/heads_quarters/nt_rep)
"o" = (
/obj/machinery/door/airlock/corporate{
	name = "NT Consultant's Office"
	},
/obj/effect/mapping_helpers/airlock/access/all/cent_com/rep_door,
/obj/structure/cable,
/obj/machinery/atmospherics/pipe/smart/manifold4w/supply/hidden/layer4,
/obj/machinery/atmospherics/pipe/smart/manifold4w/scrubbers/hidden/layer2,
/obj/structure/disposalpipe/segment{
	dir = 4
	},
/obj/machinery/door/firedoor,
/obj/effect/landmark/navigate_destination/autoname,
/obj/machinery/door/poddoor/shutters/preopen{
	name = "Robotics Surgery Shutters"
	},
/turf/open/floor/iron,
/area/station/command/heads_quarters/nt_rep)
"q" = (
/obj/machinery/button/door/directional/west{
	id = "nt_rep_priv";
	name = "Privacy Shutters Control";
	pixel_y = 8
	},
/turf/closed/wall,
/area/station/command/heads_quarters/nt_rep)
"s" = (
/obj/machinery/atmospherics/components/unary/vent_scrubber/on/layer2{
	dir = 8
	},
/obj/structure/cable,
/obj/effect/turf_decal/siding/wood{
	dir = 4
	},
/turf/open/floor/wood,
/area/station/command/heads_quarters/nt_rep)
"t" = (
/turf/closed/wall,
/area/station/maintenance/starboard/upper)
"u" = (
/obj/machinery/power/apc/auto_name/directional/south,
/obj/structure/cable,
/obj/effect/turf_decal/siding/wood{
	dir = 1
	},
/turf/open/floor/wood,
/area/station/command/heads_quarters/nt_rep)
"w" = (
/obj/machinery/firealarm/directional/north,
/obj/machinery/photocopier/prebuilt,
/turf/open/floor/wood,
/area/station/command/heads_quarters/nt_rep)
"x" = (
/turf/open/floor/carpet/executive,
/area/station/command/heads_quarters/nt_rep)
"z" = (
/obj/structure/cable,
/obj/effect/turf_decal/siding/wood/corner{
	dir = 4
	},
/turf/open/floor/wood,
/area/station/command/heads_quarters/nt_rep)
"A" = (
/obj/structure/noticeboard/directional/north{
	name = "Nanotrasen Consultant's Notice Board"
	},
/obj/structure/aquarium/prefilled,
/obj/item/reagent_containers/cup/fish_feed{
	pixel_y = 17;
	pixel_x = -3
	},
/turf/open/floor/carpet/executive,
/area/station/command/heads_quarters/nt_rep)
"B" = (
/obj/structure/safe/floor,
/obj/item/clothing/accessory/medal/gold/nanotrasen_consultant,
/obj/item/clothing/accessory/medal/silver/bureaucracy,
/obj/item/clothing/accessory/medal/gold/ordom,
/obj/machinery/keycard_auth/wall_mounted/directional/east,
/turf/open/floor/carpet/executive,
/area/station/command/heads_quarters/nt_rep)
"D" = (
/obj/machinery/status_display/ai/directional/east,
/obj/machinery/light/directional/east,
/obj/effect/turf_decal/siding/wood{
	dir = 1
	},
/turf/open/floor/wood,
/area/station/command/heads_quarters/nt_rep)
"F" = (
/turf/closed/wall,
/area/station/command/heads_quarters/qm)
"G" = (
/obj/machinery/status_display/evac/directional/north,
/obj/structure/table/wood/fancy/blue,
/obj/machinery/fax{
	fax_name = "Nanotrasen Consultant's Office";
	name = "Nanotrasen Consultant's Fax Machine"
	},
/turf/open/floor/carpet/executive,
/area/station/command/heads_quarters/nt_rep)
"K" = (
/obj/machinery/holopad,
/obj/structure/cable,
/obj/effect/turf_decal/siding/wood{
	dir = 4
	},
/turf/open/floor/wood,
/area/station/command/heads_quarters/nt_rep)
"L" = (
/obj/structure/table/reinforced/titaniumglass,
/obj/item/paper_bin{
	pixel_y = 5;
	pixel_x = -4
	},
/obj/item/pen/fountain/nanotrasen{
	pixel_y = 5;
	pixel_x = -4
	},
/obj/item/radio/intercom/directional/west,
/obj/machinery/camera/autoname/directional/west,
/obj/item/stamp/granted{
	pixel_x = 8;
	pixel_y = 11
	},
/obj/item/stamp/denied{
	pixel_x = 8;
	pixel_y = 7
	},
/obj/item/stamp/nanotrasen{
	pixel_x = 8;
	pixel_y = 2
	},
/turf/open/floor/carpet/executive,
/area/station/command/heads_quarters/nt_rep)
"O" = (
/obj/structure/chair/office{
	dir = 1
	},
/obj/item/radio/intercom/directional/south,
/obj/effect/landmark/start/nanotrasen_crew_trainer,
/turf/open/floor/wood,
/area/station/command/heads_quarters/nt_rep)
"Q" = (
/obj/machinery/disposal/bin,
/obj/structure/disposalpipe/trunk,
/obj/machinery/light{
	dir = 1
	},
/turf/open/floor/wood,
/area/station/command/heads_quarters/nt_rep)
"R" = (
/obj/structure/cable,
/obj/machinery/atmospherics/pipe/smart/manifold4w/supply/hidden/layer4,
/obj/machinery/atmospherics/pipe/smart/manifold4w/scrubbers/hidden/layer2,
/obj/structure/disposalpipe/segment{
	dir = 9
	},
/turf/open/floor/wood,
/area/station/command/heads_quarters/nt_rep)
"S" = (
/obj/structure/table/reinforced/titaniumglass,
/obj/item/flashlight/lamp/green{
	pixel_y = 14;
	pixel_x = 5
	},
/obj/machinery/recharger{
	pixel_y = 3;
	pixel_x = -6
	},
/obj/item/phone{
	pixel_x = 8;
	pixel_y = -1
	},
/turf/open/floor/carpet/executive,
/area/station/command/heads_quarters/nt_rep)
"U" = (
/obj/machinery/newscaster/directional/south,
/obj/structure/cable,
/obj/effect/turf_decal/siding/wood{
	dir = 1
	},
/turf/open/floor/wood,
/area/station/command/heads_quarters/nt_rep)
"V" = (
/obj/machinery/light_switch/directional/south,
/obj/machinery/computer/station_goal{
	dir = 4
	},
/turf/open/floor/wood,
/area/station/command/heads_quarters/nt_rep)
"Y" = (
/turf/closed/wall,
/area/station/command/heads_quarters/nt_rep)

(1,1,1) = {"
c
a
o
a
a
Y
"}
(2,1,1) = {"
Y
Q
R
k
V
Y
"}
(3,1,1) = {"
Y
w
n
i
O
q
"}
(4,1,1) = {"
Y
d
s
K
z
Y
"}
(5,1,1) = {"
Y
A
x
L
U
Y
"}
(6,1,1) = {"
Y
G
b
h
u
Y
"}
(7,1,1) = {"
Y
e
B
S
D
Y
"}
(8,1,1) = {"
f
F
F
F
F
t
"}
