//MAP CONVERTED BY dmm2tgm.py THIS HEADER COMMENT PREVENTS RECONVERSION, DO NOT REMOVE
"bb" = (
/turf/open/floor/iron/white,
/area/station/security/medical)
"bW" = (
/obj/effect/turf_decal/tile/red/half/contrasted{
	dir = 8
	},
/obj/structure/table/optable,
/obj/item/wallframe/defib_mount,
/obj/machinery/light/small/directional/north{
	dir = 8
	},
/turf/open/floor/iron/white,
/area/station/security/medical)
"ho" = (
/obj/machinery/atmospherics/components/unary/vent_pump/on/layer4{
	dir = 8
	},
/turf/open/floor/iron/white,
/area/station/security/medical)
"hZ" = (
/obj/structure/table,
/obj/effect/turf_decal/tile/red/half/contrasted{
	dir = 4
	},
/obj/machinery/airalarm/directional/east,
/obj/item/folder/white{
	pixel_x = -10;
	pixel_y = 7
	},
/obj/item/folder/red{
	pixel_x = 9;
	pixel_y = 7
	},
/obj/machinery/computer/records/medical/laptop,
/turf/open/floor/iron/white,
/area/station/security/medical)
"ik" = (
/turf/closed/wall,
/area/station/security/medical)
"iE" = (
/obj/machinery/atmospherics/pipe/multiz/scrubbers/visible/layer2,
/obj/machinery/atmospherics/pipe/multiz/supply/visible/layer4,
/turf/open/floor/plating,
/area/station/maintenance/department/security)
"kb" = (
/obj/structure/window/spawner/directional/south,
/obj/structure/bed/medical/emergency,
/obj/effect/turf_decal/tile/red/half/contrasted{
	dir = 8
	},
/obj/item/toy/plush/beeplushie{
	name = "Dr. Bees";
	desc = "When in doubt, just ask yourself: What would Dr. Bees do?."
	},
/obj/structure/sign/poster/contraband/beekind/directional/west,
/turf/open/floor/iron/white,
/area/station/security/medical)
"mF" = (
/obj/machinery/atmospherics/pipe/smart/manifold4w/supply/hidden/layer4,
/obj/machinery/atmospherics/pipe/smart/manifold4w/scrubbers/hidden/layer2,
/obj/structure/cable,
/turf/open/floor/iron/white,
/area/station/security/medical)
"tc" = (
/obj/effect/turf_decal/tile/red/half/contrasted{
	dir = 8
	},
/obj/structure/window/spawner/directional/north,
/obj/machinery/computer/operating{
	dir = 4
	},
/obj/structure/extinguisher_cabinet/directional/west,
/turf/open/floor/iron/white,
/area/station/security/medical)
"uG" = (
/obj/structure/cable,
/obj/machinery/atmospherics/pipe/smart/manifold4w/scrubbers/hidden/layer2,
/obj/machinery/atmospherics/pipe/smart/manifold4w/supply/hidden/layer4,
/turf/open/floor/plating,
/area/station/maintenance/department/security)
"uJ" = (
/obj/item/clothing/mask/surgical,
/obj/item/reagent_containers/spray/cleaner,
/obj/effect/turf_decal/tile/red/half/contrasted{
	dir = 8
	},
/obj/item/storage/medkit/surgery{
	pixel_x = -4;
	pixel_y = 10
	},
/obj/structure/table/reinforced/rglass,
/obj/item/healthanalyzer,
/obj/item/clothing/gloves/latex,
/turf/open/floor/iron/white,
/area/station/security/medical)
"vT" = (
/obj/machinery/portable_atmospherics/canister/nitrous_oxide,
/obj/structure/ladder,
/obj/structure/sign/poster/contraband/andromeda_bitters/directional/south,
/turf/open/floor/plating,
/area/station/maintenance/department/security)
"wN" = (
/turf/closed/wall/r_wall,
/area/station/security/medical)
"xC" = (
/obj/machinery/portable_atmospherics/canister/air,
/obj/item/tank/internals/oxygen,
/turf/open/floor/plating,
/area/station/maintenance/department/security)
"zm" = (
/obj/effect/landmark/start/security_medic,
/turf/open/floor/iron/white,
/area/station/security/medical)
"BW" = (
/obj/effect/turf_decal/tile/red/half/contrasted{
	dir = 8
	},
/obj/item/reagent_containers/cup/bottle/multiver{
	pixel_x = 3;
	pixel_y = 5
	},
/obj/item/reagent_containers/cup/bottle/epinephrine{
	pixel_x = -8;
	pixel_y = 8
	},
/obj/item/storage/medkit/regular,
/obj/item/reagent_containers/syringe,
/obj/structure/table/reinforced/rglass,
/obj/item/storage/medkit/brute,
/obj/item/storage/medkit/fire,
/obj/item/storage/medkit/o2,
/obj/item/storage/medkit/toxin,
/turf/open/floor/iron/white,
/area/station/security/medical)
"Dt" = (
/obj/effect/turf_decal/tile/red/half/contrasted{
	dir = 4
	},
/obj/structure/closet/secure_closet/security_medic,
/obj/item/wallframe/frontier_medstation,
/turf/open/floor/iron/white,
/area/station/security/medical)
"Em" = (
/obj/machinery/atmospherics/pipe/smart/manifold4w/scrubbers/hidden/layer2,
/obj/structure/cable,
/obj/machinery/atmospherics/pipe/smart/manifold4w/supply/hidden/layer4,
/turf/open/floor/iron/white,
/area/station/security/medical)
"Fl" = (
/obj/machinery/iv_drip,
/obj/item/radio/intercom/directional/east,
/obj/effect/turf_decal/tile/red/half/contrasted{
	dir = 4
	},
/turf/open/floor/iron/white,
/area/station/security/medical)
"Ie" = (
/obj/machinery/light/directional/north,
/obj/structure/cable,
/obj/machinery/atmospherics/pipe/smart/manifold4w/scrubbers/hidden/layer2,
/obj/machinery/atmospherics/pipe/smart/manifold4w/supply/hidden/layer4,
/turf/open/floor/iron/white,
/area/station/security/medical)
"IJ" = (
/obj/structure/bodycontainer/morgue,
/obj/effect/turf_decal/tile/red/half/contrasted{
	dir = 8
	},
/turf/open/floor/iron/white,
/area/station/security/medical)
"Jo" = (
/obj/machinery/door/airlock/maintenance{
	name = "Brig Infirmary Maintenance"
	},
/obj/effect/mapping_helpers/airlock/access/all/security/general,
/obj/structure/cable,
/obj/machinery/atmospherics/pipe/smart/manifold4w/scrubbers/hidden/layer2,
/obj/machinery/atmospherics/pipe/smart/manifold4w/supply/hidden/layer4,
/turf/open/floor/plating,
/area/station/security/medical)
"Nf" = (
/turf/template_noop,
/area/template_noop)
"Nq" = (
/obj/structure/window/spawner/directional/south,
/obj/structure/bed,
/obj/item/bedsheet,
/obj/machinery/power/apc/auto_name/directional/east,
/obj/structure/cable,
/obj/effect/turf_decal/tile/red/half/contrasted{
	dir = 4
	},
/turf/open/floor/iron/white,
/area/station/security/medical)
"OC" = (
/turf/closed/wall/r_wall/fakewood,
/area/station/security/medical)
"PJ" = (
/obj/structure/bed,
/obj/item/bedsheet,
/obj/effect/turf_decal/tile/red/half/contrasted{
	dir = 4
	},
/obj/machinery/wall_healer/directional/east,
/turf/open/floor/iron/white,
/area/station/security/medical)
"RV" = (
/obj/machinery/atmospherics/components/unary/vent_scrubber/on/layer2{
	dir = 8
	},
/turf/open/floor/iron/white,
/area/station/security/medical)
"RZ" = (
/obj/machinery/atmospherics/pipe/smart/manifold4w/supply/hidden/layer4,
/obj/machinery/atmospherics/pipe/smart/manifold4w/scrubbers/hidden/layer2,
/obj/structure/cable/multilayer/multiz,
/turf/open/floor/plating,
/area/station/maintenance/department/security)
"Tf" = (
/obj/machinery/door/window/left/directional/south{
	name = "Brig Infirmary"
	},
/obj/machinery/atmospherics/pipe/smart/manifold4w/supply/hidden/layer4,
/obj/machinery/atmospherics/pipe/smart/manifold4w/scrubbers/hidden/layer2,
/obj/structure/cable,
/turf/open/floor/iron/white,
/area/station/security/medical)
"Tl" = (
/obj/structure/cable,
/obj/machinery/camera/directional/north{
	c_tag = "Security - Infirmary"
	},
/obj/machinery/atmospherics/pipe/smart/manifold4w/scrubbers/hidden/layer2,
/obj/machinery/atmospherics/pipe/smart/manifold4w/supply/hidden/layer4,
/turf/open/floor/iron/white,
/area/station/security/medical)
"Wf" = (
/obj/structure/cable,
/obj/machinery/atmospherics/pipe/smart/manifold4w/scrubbers/hidden/layer2,
/obj/machinery/atmospherics/pipe/smart/manifold4w/supply/hidden/layer4,
/obj/effect/turf_decal/tile/red/half/contrasted{
	dir = 4
	},
/turf/open/floor/iron/white,
/area/station/security/medical)
"Ye" = (
/obj/machinery/door/window/right/directional/south{
	name = "Brig Infirmary"
	},
/obj/structure/cable,
/turf/open/floor/iron/white,
/area/station/security/medical)
"YF" = (
/obj/effect/landmark/blobstart,
/turf/open/floor/plating,
/area/station/maintenance/department/security)

(1,1,1) = {"
Nf
Nf
Nf
OC
OC
OC
OC
wN
wN
wN
"}
(2,1,1) = {"
Nf
Nf
vT
wN
IJ
tc
bW
uJ
BW
kb
"}
(3,1,1) = {"
Nf
Nf
Nf
wN
Tl
Em
Em
Em
mF
Tf
"}
(4,1,1) = {"
Nf
Nf
Nf
wN
Ie
RV
bb
zm
ho
Ye
"}
(5,1,1) = {"
iE
RZ
uG
Jo
Wf
Dt
hZ
PJ
Fl
Nq
"}
(6,1,1) = {"
YF
xC
uG
wN
ik
ik
ik
ik
ik
ik
"}
(7,1,1) = {"
Nf
Nf
uG
Nf
Nf
Nf
Nf
Nf
Nf
Nf
"}
