//MAP CONVERTED BY dmm2tgm.py THIS HEADER COMMENT PREVENTS RECONVERSION, DO NOT REMOVE
"a" = (
/obj/effect/turf_decal/trimline/blue/filled/line{
	dir = 9
	},
/obj/effect/turf_decal/trimline/dark/line{
	dir = 9
	},
/obj/structure/table/reinforced/rglass,
/obj/effect/spawner/surgery_tray/full,
/obj/machinery/defibrillator_mount/directional/north,
/obj/machinery/airalarm/directional/west,
/turf/open/floor/iron/white,
/area/station/security/medical)
"b" = (
/obj/structure/disposalpipe/segment{
	dir = 4
	},
/obj/effect/turf_decal/trimline/red/filled/line{
	dir = 1
	},
/obj/effect/turf_decal/trimline/red/filled/mid_joiner{
	dir = 1
	},
/obj/effect/turf_decal/trimline/dark_red/line{
	dir = 1
	},
/obj/structure/extinguisher_cabinet/directional/north,
/turf/open/floor/iron/smooth_large,
/area/station/security/brig)
"c" = (
/obj/structure/window/reinforced/spawner/directional/south,
/obj/machinery/computer/records/medical{
	dir = 1
	},
/turf/open/floor/iron/dark/textured,
/area/station/security/medical)
"f" = (
/turf/closed/wall,
/area/station/security/medical)
"g" = (
/obj/structure/table/reinforced,
/obj/structure/sign/calendar/directional/east,
/obj/item/healthanalyzer{
	pixel_x = 5;
	pixel_y = 14
	},
/obj/item/reagent_containers/cup/glass/mug/nanotrasen{
	pixel_x = 9;
	pixel_y = 8
	},
/obj/item/clothing/gloves/latex{
	pixel_x = 0;
	pixel_y = -6
	},
/obj/item/clothing/mask/surgical{
	pixel_x = 0;
	pixel_y = -6
	},
/turf/open/floor/iron/dark/textured,
/area/station/security/medical)
"h" = (
/obj/structure/window/reinforced/spawner/directional/south,
/obj/effect/turf_decal/trimline/red/real_red/end,
/obj/effect/turf_decal/siding/dark/end,
/obj/structure/bodycontainer/morgue{
	dir = 1
	},
/obj/effect/turf_decal/tile/neutral/half/contrasted{
	dir = 8
	},
/obj/machinery/status_display/evac/directional/east,
/turf/open/floor/iron/dark,
/area/station/security/medical)
"i" = (
/obj/structure/window/reinforced/spawner/directional/south,
/obj/structure/table/reinforced,
/obj/item/reagent_containers/blood/o_minus{
	pixel_x = -6;
	pixel_y = 7
	},
/obj/item/paper/fluff/jobs/medical/blood_types{
	pixel_x = 5;
	pixel_y = 11
	},
/obj/item/reagent_containers/blood/o_minus{
	pixel_x = -2;
	pixel_y = 3
	},
/obj/item/reagent_containers/blood/lizard{
	pixel_x = 4;
	pixel_y = -1
	},
/turf/open/floor/iron/dark/textured,
/area/station/security/medical)
"j" = (
/obj/effect/turf_decal/trimline/blue/filled/line{
	dir = 6
	},
/obj/effect/turf_decal/trimline/dark/line{
	dir = 6
	},
/obj/structure/chair/office/light{
	dir = 4
	},
/obj/effect/landmark/start/security_medic,
/turf/open/floor/iron/white,
/area/station/security/medical)
"k" = (
/obj/structure/sign/departments/medbay/alt,
/turf/closed/wall,
/area/station/security/medical)
"m" = (
/obj/structure/window/reinforced/spawner/directional/south,
/obj/structure/table/reinforced,
/obj/structure/window/reinforced/spawner/directional/west,
/obj/item/paper_bin{
	pixel_x = -1;
	pixel_y = 4
	},
/obj/item/pen{
	pixel_x = -1;
	pixel_y = 6
	},
/turf/open/floor/iron/dark/textured,
/area/station/security/medical)
"n" = (
/obj/effect/turf_decal/trimline/blue/filled/line{
	dir = 6
	},
/obj/effect/turf_decal/trimline/blue/filled/mid_joiner,
/obj/effect/turf_decal/trimline/blue/filled/mid_joiner{
	dir = 4
	},
/turf/open/floor/iron/white/smooth_large,
/area/station/security/medical)
"o" = (
/turf/closed/wall/r_wall,
/area/station/security/medical)
"p" = (
/obj/structure/disposalpipe/segment{
	dir = 4
	},
/obj/effect/turf_decal/trimline/red/filled/line{
	dir = 1
	},
/obj/effect/turf_decal/trimline/red/filled/mid_joiner{
	dir = 1
	},
/obj/effect/turf_decal/trimline/dark_red/line{
	dir = 1
	},
/obj/machinery/light/directional/north,
/obj/machinery/camera/directional/north{
	c_tag = "Security - Starboard Hallway"
	},
/turf/open/floor/iron/smooth_large,
/area/station/security/brig)
"q" = (
/obj/effect/turf_decal/trimline/blue/filled/line{
	dir = 4
	},
/obj/effect/turf_decal/trimline/dark/line{
	dir = 4
	},
/turf/open/floor/iron/white/smooth_edge{
	dir = 8
	},
/area/station/security/medical)
"r" = (
/obj/machinery/camera/directional/north{
	c_tag = "Security - Infirmary"
	},
/obj/effect/turf_decal/trimline/blue/filled/line{
	dir = 1
	},
/obj/effect/turf_decal/trimline/dark/line{
	dir = 1
	},
/obj/effect/turf_decal/trimline/blue/filled/corner,
/obj/structure/table/optable,
/obj/machinery/vitals_reader/directional/north,
/turf/open/floor/iron/white/smooth_edge,
/area/station/security/medical)
"s" = (
/obj/effect/turf_decal/trimline/blue/filled/line{
	dir = 4
	},
/obj/effect/turf_decal/trimline/dark/line{
	dir = 4
	},
/obj/structure/cable,
/turf/open/floor/iron/white/smooth_edge{
	dir = 8
	},
/area/station/security/medical)
"t" = (
/obj/effect/turf_decal/trimline/blue/filled/line{
	dir = 1
	},
/obj/effect/turf_decal/trimline/dark/line{
	dir = 1
	},
/obj/structure/closet/secure_closet/security_medic,
/obj/machinery/wall_healer/directional/north,
/turf/open/floor/iron/white/smooth_edge,
/area/station/security/medical)
"v" = (
/obj/effect/turf_decal/trimline/blue/filled/line{
	dir = 9
	},
/obj/effect/turf_decal/trimline/blue/filled/mid_joiner{
	dir = 1
	},
/obj/effect/turf_decal/trimline/blue/filled/mid_joiner{
	dir = 8
	},
/obj/structure/cable,
/obj/machinery/atmospherics/pipe/smart/manifold4w/supply/hidden/layer4,
/obj/machinery/atmospherics/pipe/smart/manifold4w/scrubbers/hidden/layer2,
/turf/open/floor/iron/white/smooth_large,
/area/station/security/medical)
"w" = (
/obj/effect/turf_decal/trimline/blue/filled/corner{
	dir = 4
	},
/obj/effect/turf_decal/trimline/blue/filled/line,
/obj/effect/turf_decal/trimline/dark/line,
/turf/open/floor/iron/white/smooth_edge{
	dir = 1
	},
/area/station/security/medical)
"x" = (
/obj/machinery/light/directional/north,
/obj/effect/turf_decal/trimline/blue/filled/line{
	dir = 1
	},
/obj/effect/turf_decal/trimline/dark/line{
	dir = 1
	},
/obj/effect/turf_decal/trimline/blue/filled/corner{
	dir = 8
	},
/obj/machinery/computer/operating{
	dir = 2
	},
/obj/item/radio/intercom/directional/north,
/turf/open/floor/iron/white/smooth_edge,
/area/station/security/medical)
"y" = (
/obj/effect/turf_decal/trimline/blue/filled/line{
	dir = 5
	},
/obj/effect/turf_decal/trimline/dark/line{
	dir = 5
	},
/obj/machinery/power/apc/auto_name/directional/north,
/obj/structure/cable,
/turf/open/floor/iron/white,
/area/station/security/medical)
"z" = (
/obj/structure/extinguisher_cabinet/directional/west,
/obj/effect/turf_decal/trimline/blue/filled/line{
	dir = 8
	},
/obj/effect/turf_decal/trimline/dark/line{
	dir = 8
	},
/obj/effect/turf_decal/trimline/blue/filled/corner{
	dir = 4
	},
/turf/open/floor/iron/white/smooth_edge{
	dir = 4
	},
/area/station/security/medical)
"A" = (
/obj/structure/window/reinforced/spawner/directional/south,
/obj/structure/table/reinforced,
/obj/item/folder/white{
	pixel_x = -12;
	pixel_y = 0
	},
/obj/item/folder/red{
	pixel_x = -8;
	pixel_y = 0
	},
/obj/item/reagent_containers/spray/cleaner{
	pixel_x = 7;
	pixel_y = 3
	},
/turf/open/floor/iron/dark/textured,
/area/station/security/medical)
"D" = (
/obj/structure/disposalpipe/segment{
	dir = 4
	},
/obj/effect/turf_decal/trimline/red/filled/line{
	dir = 1
	},
/obj/effect/turf_decal/trimline/red/filled/mid_joiner{
	dir = 1
	},
/obj/effect/turf_decal/trimline/dark_red/line{
	dir = 1
	},
/turf/open/floor/iron/smooth_large,
/area/station/security/brig)
"F" = (
/obj/effect/turf_decal/trimline/blue/filled/line{
	dir = 10
	},
/obj/effect/turf_decal/trimline/blue/filled/mid_joiner,
/obj/effect/turf_decal/trimline/blue/filled/mid_joiner{
	dir = 8
	},
/obj/structure/cable,
/obj/machinery/atmospherics/pipe/smart/manifold4w/supply/hidden/layer4,
/obj/effect/landmark/start/security_medic,
/turf/open/floor/iron/white/smooth_large,
/area/station/security/medical)
"H" = (
/obj/effect/turf_decal/trimline/blue/filled/line{
	dir = 10
	},
/obj/effect/turf_decal/trimline/dark/line{
	dir = 10
	},
/obj/machinery/firealarm/directional/west{
	pixel_x = -26;
	pixel_y = -5
	},
/obj/structure/chair/office/light,
/obj/effect/landmark/start/security_medic,
/obj/machinery/light_switch/directional/west{
	pixel_x = -26;
	pixel_y = 5
	},
/turf/open/floor/iron/white,
/area/station/security/medical)
"K" = (
/obj/structure/table/reinforced,
/obj/structure/sign/clock/directional/east,
/obj/item/reagent_containers/cup/bottle/epinephrine{
	pixel_x = 9;
	pixel_y = 8
	},
/obj/item/reagent_containers/cup/bottle/multiver{
	pixel_x = 9;
	pixel_y = 1
	},
/obj/item/reagent_containers/syringe{
	pixel_x = 2;
	pixel_y = -10
	},
/obj/item/storage/box/bodybags{
	pixel_y = 8;
	pixel_x = -5
	},
/turf/open/floor/iron/dark/textured,
/area/station/security/medical)
"N" = (
/obj/effect/turf_decal/trimline/blue/filled/line{
	dir = 4
	},
/obj/effect/turf_decal/trimline/blue/filled/line{
	dir = 8
	},
/obj/effect/turf_decal/trimline/dark/line{
	dir = 4
	},
/obj/effect/turf_decal/trimline/dark/line{
	dir = 8
	},
/obj/machinery/door/airlock/security/glass{
	name = "Brig Infirmiary"
	},
/obj/machinery/door/firedoor,
/obj/effect/mapping_helpers/airlock/access/any/security/general,
/obj/structure/cable,
/obj/machinery/atmospherics/pipe/smart/manifold4w/supply/hidden/layer4,
/obj/machinery/atmospherics/pipe/smart/manifold4w/scrubbers/hidden/layer2,
/turf/open/floor/iron/white/textured,
/area/station/security/medical)
"O" = (
/obj/effect/turf_decal/trimline/blue/filled/line{
	dir = 5
	},
/obj/effect/turf_decal/trimline/blue/filled/mid_joiner{
	dir = 1
	},
/obj/effect/turf_decal/trimline/blue/filled/mid_joiner{
	dir = 4
	},
/turf/open/floor/iron/white/smooth_large,
/area/station/security/medical)
"R" = (
/obj/structure/window/reinforced/spawner/directional/south,
/obj/structure/window/reinforced/spawner/directional/east,
/obj/machinery/computer/crew{
	dir = 1
	},
/turf/open/floor/iron/dark/textured,
/area/station/security/medical)
"S" = (
/obj/effect/turf_decal/trimline/blue/filled/line,
/obj/effect/turf_decal/trimline/dark/line,
/turf/open/floor/iron/white/smooth_edge{
	dir = 1
	},
/area/station/security/medical)
"T" = (
/obj/effect/turf_decal/trimline/blue/filled/line{
	dir = 8
	},
/obj/effect/turf_decal/trimline/dark/line{
	dir = 8
	},
/obj/effect/turf_decal/trimline/blue/filled/corner,
/obj/machinery/stasis{
	dir = 4
	},
/obj/item/bedsheet/medical{
	dir = 4
	},
/obj/machinery/iv_drip,
/obj/machinery/vitals_reader/directional/west,
/turf/open/floor/iron/white/smooth_edge{
	dir = 4
	},
/area/station/security/medical)
"U" = (
/obj/structure/disposalpipe/segment{
	dir = 4
	},
/obj/effect/turf_decal/trimline/red/filled/line{
	dir = 1
	},
/obj/effect/turf_decal/trimline/red/filled/mid_joiner{
	dir = 1
	},
/obj/effect/turf_decal/trimline/dark_red/line{
	dir = 1
	},
/obj/machinery/atmospherics/pipe/smart/manifold4w/supply/hidden/layer4,
/obj/structure/cable,
/obj/machinery/atmospherics/pipe/smart/manifold4w/scrubbers/hidden/layer2,
/turf/open/floor/iron/smooth_large,
/area/station/security/brig)
"V" = (
/obj/effect/turf_decal/trimline/red/real_red/end{
	dir = 1
	},
/obj/effect/turf_decal/siding/dark/end{
	dir = 1
	},
/obj/structure/sign/poster/official/cleanliness/directional/east,
/obj/structure/sink/directional/west,
/obj/effect/turf_decal/tile/neutral/half/contrasted{
	dir = 8
	},
/obj/machinery/light/small/directional/north,
/turf/open/floor/iron/dark,
/area/station/security/medical)
"W" = (
/obj/effect/turf_decal/trimline/blue/filled/corner{
	dir = 1
	},
/obj/machinery/atmospherics/components/unary/vent_scrubber/on/layer2{
	dir = 8
	},
/turf/open/floor/iron/white/smooth_large,
/area/station/security/medical)
"X" = (
/obj/effect/turf_decal/trimline/blue/filled/corner{
	dir = 8
	},
/obj/structure/cable,
/obj/machinery/atmospherics/components/unary/vent_pump/on/layer4{
	dir = 8
	},
/turf/open/floor/iron/white/smooth_large,
/area/station/security/medical)
"Z" = (
/obj/effect/turf_decal/trimline/blue/filled/corner{
	dir = 1
	},
/obj/effect/turf_decal/trimline/blue/filled/corner{
	dir = 8
	},
/obj/effect/turf_decal/trimline/blue/filled/corner,
/obj/effect/turf_decal/trimline/dark/corner{
	dir = 8
	},
/obj/effect/turf_decal/trimline/dark/corner,
/obj/structure/cable,
/obj/machinery/atmospherics/pipe/smart/manifold4w/supply/hidden/layer4,
/obj/machinery/atmospherics/pipe/smart/manifold4w/scrubbers/hidden/layer2,
/turf/open/floor/iron/white/smooth_edge{
	dir = 1
	},
/area/station/security/medical)

(1,1,1) = {"
o
o
o
o
f
f
b
"}
(2,1,1) = {"
o
a
T
z
H
c
D
"}
(3,1,1) = {"
o
r
n
O
w
R
D
"}
(4,1,1) = {"
o
x
F
v
Z
N
U
"}
(5,1,1) = {"
o
t
X
W
S
m
D
"}
(6,1,1) = {"
o
y
s
q
j
A
D
"}
(7,1,1) = {"
o
V
h
K
g
i
D
"}
(8,1,1) = {"
o
f
f
f
f
k
p
"}
