//MAP CONVERTED BY dmm2tgm.py THIS HEADER COMMENT PREVENTS RECONVERSION, DO NOT REMOVE
"bb" = (
/turf/open/floor/iron/white,
/area/station/security/medical)
"bW" = (
/obj/effect/turf_decal/tile/red/half/contrasted{
	dir = 1
	},
/obj/effect/turf_decal/siding/dark/corner{
	dir = 1
	},
/turf/open/floor/iron/white,
/area/station/security/medical)
"ho" = (
/obj/machinery/atmospherics/pipe/smart/manifold4w/supply/hidden/layer4,
/obj/structure/cable,
/obj/machinery/atmospherics/pipe/smart/manifold4w/scrubbers/hidden/layer2,
/turf/open/floor/iron/white,
/area/station/security/medical)
"hZ" = (
/obj/machinery/atmospherics/components/unary/vent_scrubber/on/layer2{
	dir = 8
	},
/obj/effect/landmark/start/security_medic,
/obj/effect/turf_decal/tile/red/anticorner/contrasted,
/obj/effect/turf_decal/siding/dark_red{
	dir = 6
	},
/turf/open/floor/iron/white,
/area/station/security/medical)
"iE" = (
/obj/structure/bed,
/obj/item/bedsheet,
/obj/effect/turf_decal/tile/red/half/contrasted{
	dir = 4
	},
/turf/open/floor/iron/white,
/area/station/security/medical)
"kb" = (
/obj/effect/turf_decal/tile/red/half/contrasted{
	dir = 4
	},
/turf/open/floor/iron/white,
/area/station/security/medical)
"mF" = (
/obj/item/clothing/mask/surgical,
/obj/item/reagent_containers/spray/cleaner,
/obj/effect/turf_decal/tile/red/half/contrasted{
	dir = 8
	},
/obj/item/storage/medkit/surgery{
	pixel_x = -4;
	pixel_y = 10
	},
/obj/item/healthanalyzer,
/obj/item/clothing/gloves/latex,
/obj/structure/table{
	layer = 2.9
	},
/obj/structure/ladder{
	layer = 2.8
	},
/turf/open/floor/iron/white,
/area/station/security/medical)
"tc" = (
/obj/effect/turf_decal/tile/red/half/contrasted{
	dir = 8
	},
/obj/structure/window/spawner/directional/north,
/obj/machinery/computer/operating{
	dir = 4
	},
/obj/structure/extinguisher_cabinet/directional/west,
/turf/open/floor/iron/white,
/area/station/security/medical)
"uJ" = (
/obj/machinery/atmospherics/pipe/smart/manifold4w/scrubbers/hidden/layer2,
/obj/structure/cable,
/obj/machinery/atmospherics/pipe/smart/manifold4w/supply/hidden/layer4,
/obj/effect/turf_decal/tile/red/half/contrasted,
/obj/effect/turf_decal/siding/dark/corner,
/turf/open/floor/iron/white,
/area/station/security/medical)
"vT" = (
/obj/structure/cable,
/obj/machinery/atmospherics/pipe/smart/manifold4w/scrubbers/hidden/layer2,
/obj/machinery/atmospherics/pipe/smart/manifold4w/supply/hidden/layer4,
/obj/item/reagent_containers/syringe,
/obj/item/reagent_containers/cup/bottle/multiver,
/obj/item/reagent_containers/cup/bottle/epinephrine,
/obj/item/storage/medkit/regular,
/obj/structure/table,
/obj/machinery/power/apc/auto_name/directional/north,
/obj/item/storage/medkit/toxin,
/obj/item/storage/medkit/o2,
/obj/item/storage/medkit/fire,
/obj/item/storage/medkit/brute,
/obj/effect/turf_decal/tile/red/half/contrasted{
	dir = 8
	},
/obj/effect/turf_decal/siding/dark/corner{
	dir = 8
	},
/turf/open/floor/iron/white,
/area/station/security/medical)
"xC" = (
/obj/effect/turf_decal/tile/red/anticorner/contrasted{
	dir = 1
	},
/obj/effect/turf_decal/siding/dark_red{
	dir = 9
	},
/turf/open/floor/iron/white,
/area/station/security/medical)
"zm" = (
/obj/machinery/atmospherics/pipe/smart/manifold4w/scrubbers/hidden/layer2,
/obj/structure/cable,
/obj/machinery/atmospherics/pipe/smart/manifold4w/supply/hidden/layer4,
/obj/effect/landmark/start/security_medic,
/obj/effect/turf_decal/tile/red/half/contrasted{
	dir = 1
	},
/obj/effect/turf_decal/siding/dark/corner{
	dir = 4
	},
/turf/open/floor/iron/white,
/area/station/security/medical)
"BW" = (
/turf/closed/wall,
/area/station/security/medical)
"Dt" = (
/obj/machinery/light/directional/north,
/obj/structure/cable,
/obj/machinery/atmospherics/pipe/smart/manifold4w/scrubbers/hidden/layer2,
/obj/machinery/atmospherics/pipe/smart/manifold4w/supply/hidden/layer4,
/obj/structure/table,
/obj/item/folder/white{
	pixel_x = -4;
	pixel_y = 2
	},
/obj/item/folder/red{
	pixel_x = 3
	},
/obj/item/healthanalyzer,
/obj/effect/turf_decal/tile/red/half/contrasted{
	dir = 4
	},
/obj/effect/turf_decal/siding/dark/corner,
/turf/open/floor/iron/white,
/area/station/security/medical)
"Em" = (
/obj/effect/turf_decal/tile/red/half/contrasted{
	dir = 8
	},
/obj/structure/table/optable,
/obj/item/wallframe/defib_mount,
/obj/machinery/light/small/directional/west,
/turf/open/floor/iron/white,
/area/station/security/medical)
"Fl" = (
/obj/structure/closet/secure_closet/security_medic,
/obj/item/wallframe/frontier_medstation,
/obj/effect/turf_decal/tile/red/half/contrasted{
	dir = 4
	},
/obj/effect/turf_decal/siding/dark/corner{
	dir = 4
	},
/turf/open/floor/iron/white,
/area/station/security/medical)
"Ie" = (
/turf/closed/wall/r_wall,
/area/station/security/medical)
"IJ" = (
/obj/structure/bodycontainer/morgue,
/obj/effect/turf_decal/tile/red/half/contrasted{
	dir = 8
	},
/turf/open/floor/iron/white,
/area/station/security/medical)
"Nf" = (
/obj/effect/turf_decal/tile/red/anticorner/contrasted{
	dir = 8
	},
/obj/effect/turf_decal/siding/dark_red{
	dir = 10
	},
/turf/open/floor/iron/white,
/area/station/security/medical)
"Nq" = (
/obj/effect/spawner/structure/window/reinforced,
/turf/open/floor/plating,
/area/station/security/medical)
"PJ" = (
/obj/machinery/atmospherics/components/unary/vent_pump/on/layer4{
	dir = 8
	},
/obj/effect/landmark/start/security_medic,
/obj/effect/turf_decal/tile/red/anticorner/contrasted{
	dir = 4
	},
/obj/effect/turf_decal/siding/dark_red{
	dir = 5
	},
/turf/open/floor/iron/white,
/area/station/security/medical)
"RV" = (
/obj/structure/cable,
/obj/machinery/camera/directional/north{
	c_tag = "Security - Infirmary"
	},
/obj/machinery/atmospherics/pipe/smart/manifold4w/scrubbers/hidden/layer2,
/obj/machinery/atmospherics/pipe/smart/manifold4w/supply/hidden/layer4,
/obj/item/radio/intercom/directional/north,
/turf/open/floor/iron/white,
/area/station/security/medical)
"RZ" = (
/obj/machinery/computer/records/medical/laptop{
	dir = 1
	},
/obj/structure/table,
/obj/effect/turf_decal/tile/red/half/contrasted{
	dir = 8
	},
/obj/effect/turf_decal/siding/dark/corner{
	dir = 1
	},
/turf/open/floor/iron/white,
/area/station/security/medical)
"Tf" = (
/obj/machinery/airalarm/directional/east,
/obj/structure/bed,
/obj/item/bedsheet,
/obj/effect/turf_decal/tile/red/half/contrasted{
	dir = 4
	},
/turf/open/floor/iron/white,
/area/station/security/medical)
"Tl" = (
/obj/effect/turf_decal/tile/red/half/contrasted,
/obj/effect/turf_decal/siding/dark/corner{
	dir = 8
	},
/turf/open/floor/iron/white,
/area/station/security/medical)
"Wf" = (
/obj/structure/bed/medical/emergency,
/obj/effect/turf_decal/tile/red/half/contrasted{
	dir = 4
	},
/obj/item/toy/plush/beeplushie{
	name = "Dr. Bees";
	desc = "When in doubt, just ask yourself: What would Dr. Bees do?."
	},
/obj/structure/sign/poster/contraband/beekind/directional/east,
/turf/open/floor/iron/white,
/area/station/security/medical)
"Ye" = (
/obj/machinery/door/airlock/security/glass{
	name = "Brig Infirmiary"
	},
/obj/effect/mapping_helpers/airlock/access/any/security/general,
/obj/machinery/atmospherics/pipe/smart/manifold4w/supply/hidden/layer4,
/obj/structure/cable,
/obj/machinery/atmospherics/pipe/smart/manifold4w/scrubbers/hidden/layer2,
/turf/open/floor/iron/white,
/area/station/security/medical)

(1,1,1) = {"
Ie
Ie
Ie
Ie
BW
BW
"}
(2,1,1) = {"
Ie
IJ
tc
Em
mF
Nq
"}
(3,1,1) = {"
Ie
RV
uJ
zm
ho
Ye
"}
(4,1,1) = {"
Ie
Dt
hZ
PJ
Fl
Nq
"}
(5,1,1) = {"
Ie
vT
Nf
xC
RZ
Nq
"}
(6,1,1) = {"
Ie
bb
Tl
bW
bb
Nq
"}
(7,1,1) = {"
Ie
Wf
Tf
iE
kb
Nq
"}
(8,1,1) = {"
Ie
BW
BW
BW
BW
BW
"}
