//MAP CONVERTED BY dmm2tgm.py THIS HEADER COMMENT PREVENTS RECONVERSION, DO NOT REMOVE
"a" = (
/obj/machinery/cafe_condo_teleporter,
/obj/effect/turf_decal/delivery/red,
/obj/effect/turf_decal/stripes/line{
	dir = 6
	},
/obj/effect/turf_decal/stripes/line{
	dir = 8
	},
/turf/open/floor/iron/dark,
/area/template_noop)
"o" = (
/obj/machinery/computer/old{
	desc = "Due to various fly related incident, management has disabled direct control of this console.";
	icon_screen = "comm";
	name = condoteleportationconsole;
	dir = 8
	},
/obj/effect/turf_decal/stripes/line{
	dir = 4
	},
/obj/effect/turf_decal/stripes/line{
	dir = 8
	},
/turf/open/floor/iron/dark,
/area/template_noop)
"O" = (
/obj/machinery/cafe_condo_teleporter,
/obj/effect/turf_decal/delivery/blue,
/obj/effect/turf_decal/stripes/line{
	dir = 5
	},
/obj/effect/turf_decal/stripes/line{
	dir = 8
	},
/turf/open/floor/iron/dark,
/area/template_noop)

(1,1,1) = {"
O
o
a
"}
