//MAP CONVERTED BY dmm2tgm.py THIS HEADER COMMENT PREVENTS RECONVERSION, DO NOT REMOVE
"a" = (
/obj/machinery/cafe_condo_teleporter,
/obj/effect/turf_decal/delivery/red,
/obj/effect/turf_decal/stripes/line{
	dir = 10
	},
/obj/effect/turf_decal/stripes/line{
	dir = 4
	},
/turf/open/floor/iron/dark,
/area/centcom/holding/cafe/station/command/teleporter)
"j" = (
/obj/machinery/cafe_condo_teleporter,
/obj/effect/turf_decal/delivery/blue,
/obj/effect/turf_decal/stripes/line{
	dir = 9
	},
/obj/effect/turf_decal/stripes/line{
	dir = 4
	},
/turf/open/floor/iron/dark,
/area/centcom/holding/cafe/station/command/teleporter)
"o" = (
/obj/effect/turf_decal/stripes/line{
	dir = 8
	},
/obj/effect/turf_decal/stripes/line{
	dir = 4
	},
/obj/machinery/computer{
	dir = 4;
	name = "Condo Teleportation Console";
	desc = "Due to various fly related incident, management has disabled direct control of this console."
	},
/turf/open/floor/iron/dark,
/area/centcom/holding/cafe/station/command/teleporter)

(1,1,1) = {"
j
o
a
"}
