//MAP CONVERTED BY dmm2tgm.py THIS HEADER COMMENT PREVENTS RECONVERSION, DO NOT REMOVE
"a" = (
/obj/machinery/firealarm/directional/north,
/obj/effect/turf_decal/tile/neutral/anticorner/contrasted{
	dir = 8
	},
/obj/structure/disposalpipe/trunk{
	dir = 4
	},
/obj/effect/turf_decal/bot,
/obj/machinery/disposal/bin,
/turf/open/floor/iron/dark,
/area/station/security/office)
"b" = (
/obj/structure/table/reinforced,
/obj/machinery/computer/crew,
/obj/structure/window/reinforced/spawner/directional/north,
/turf/open/floor/iron/white,
/area/station/security/medical)
"e" = (
/obj/effect/landmark/event_spawn,
/obj/machinery/atmospherics/components/unary/vent_pump/on/layer4{
	dir = 1
	},
/obj/effect/landmark/start/security_medic,
/turf/open/floor/iron/white,
/area/station/security/medical)
"g" = (
/obj/effect/turf_decal/tile/neutral/half/contrasted,
/obj/structure/disposalpipe/segment{
	dir = 10
	},
/obj/item/storage/fancy/donut_box{
	pixel_x = 0;
	pixel_y = 7
	},
/obj/structure/table,
/turf/open/floor/iron/dark,
/area/station/security/office)
"h" = (
/obj/effect/spawner/structure/window/reinforced,
/obj/structure/cable,
/turf/open/floor/plating,
/area/station/security/medical)
"k" = (
/obj/machinery/door/window/brigdoor/right/directional/south{
	req_access = list("security");
	name = "Security Infirmary";
	dir = 1
	},
/obj/machinery/door/firedoor/border_only{
	dir = 1
	},
/obj/effect/turf_decal/trimline/blue/filled/line{
	dir = 5
	},
/obj/structure/cable,
/obj/machinery/atmospherics/pipe/smart/manifold4w/supply/hidden/layer4,
/obj/machinery/atmospherics/pipe/smart/manifold4w/scrubbers/hidden/layer2,
/obj/structure/sign/poster/official/cleanliness/directional/east,
/turf/open/floor/iron/white,
/area/station/security/medical)
"m" = (
/obj/effect/turf_decal/tile/neutral/opposingcorners{
	dir = 1
	},
/obj/structure/cable,
/obj/machinery/computer/records/medical/laptop{
	dir = 4;
	pixel_x = 4;
	pixel_y = 3
	},
/obj/structure/table/reinforced,
/obj/effect/turf_decal/trimline/blue/filled/line{
	dir = 8
	},
/turf/open/floor/iron/white,
/area/station/security/medical)
"n" = (
/obj/effect/turf_decal/tile/neutral/half/contrasted{
	dir = 4
	},
/obj/structure/cable,
/obj/effect/turf_decal/trimline/blue/filled/corner,
/obj/effect/turf_decal/trimline/blue/filled/line{
	dir = 8
	},
/turf/open/floor/iron/white,
/area/station/security/medical)
"o" = (
/obj/effect/turf_decal/tile/neutral/anticorner/contrasted{
	dir = 4
	},
/obj/machinery/wall_healer/directional/west,
/obj/structure/cable,
/obj/structure/closet/secure_closet/security_medic,
/obj/item/storage/box/bodybags{
	pixel_x = 0;
	pixel_y = 0
	},
/obj/item/healthanalyzer{
	pixel_x = 0;
	pixel_y = 0
	},
/obj/item/storage/box/bandages,
/obj/item/clothing/gloves/latex,
/obj/item/reagent_containers/syringe,
/obj/item/reagent_containers/cup/bottle/epinephrine,
/obj/item/storage/medkit/regular,
/obj/item/reagent_containers/spray/cleaner{
	pixel_x = 0;
	pixel_y = 0
	},
/obj/machinery/atmospherics/components/unary/vent_scrubber/on/layer2{
	dir = 4
	},
/obj/effect/turf_decal/trimline/blue/filled/line{
	dir = 8
	},
/turf/open/floor/iron/white,
/area/station/security/medical)
"q" = (
/obj/structure/cable,
/obj/effect/landmark/start/security_medic,
/obj/structure/chair/office/light{
	dir = 8
	},
/obj/effect/turf_decal/tile/blue,
/obj/effect/turf_decal/tile/blue{
	dir = 4
	},
/obj/effect/turf_decal/tile/blue{
	dir = 8
	},
/obj/machinery/atmospherics/pipe/smart/manifold4w/scrubbers/hidden/layer2,
/obj/machinery/atmospherics/pipe/smart/manifold4w/supply/hidden/layer4,
/turf/open/floor/iron/white,
/area/station/security/medical)
"r" = (
/obj/effect/turf_decal/tile/neutral/half/contrasted,
/obj/structure/disposalpipe/segment{
	dir = 4
	},
/turf/open/floor/iron/dark,
/area/station/security/office)
"s" = (
/turf/closed/wall,
/area/station/security/warden)
"t" = (
/turf/closed/wall,
/area/station/security/office)
"u" = (
/obj/machinery/door/window/brigdoor/right/directional/south{
	req_access = list("security");
	name = "Security Infirmary"
	},
/obj/machinery/door/firedoor/border_only,
/obj/effect/turf_decal/trimline/blue/filled/end,
/turf/open/floor/iron/white,
/area/station/security/medical)
"D" = (
/turf/closed/wall,
/area/station/security/medical)
"E" = (
/obj/machinery/camera/directional/east{
	c_tag = "Security Infirmary"
	},
/obj/effect/turf_decal/tile/neutral,
/obj/effect/turf_decal/trimline/blue/filled/line{
	dir = 6
	},
/obj/structure/table/reinforced/rglass,
/obj/effect/spawner/surgery_tray/full,
/obj/machinery/defibrillator_mount/directional/east,
/turf/open/floor/iron/white,
/area/station/security/medical)
"F" = (
/obj/effect/turf_decal/tile/neutral/fourcorners,
/obj/effect/turf_decal/trimline/red/real_red/end{
	dir = 8;
	alpha = 160
	},
/obj/structure/window/reinforced/spawner/directional/south,
/obj/structure/window/reinforced/spawner/directional/west,
/obj/structure/window/reinforced/survival_pod/spawner/directional{
	dir = 10
	},
/obj/effect/turf_decal/siding/dark{
	dir = 8;
	icon_state = "siding_plain_end"
	},
/turf/open/floor/iron/dark,
/area/station/security/medical)
"G" = (
/obj/structure/table/reinforced,
/obj/item/reagent_containers/cup/glass/mug/nanotrasen{
	pixel_x = 8;
	pixel_y = 0
	},
/obj/item/paper_bin{
	pixel_x = -5;
	pixel_y = 3
	},
/obj/item/pen{
	pixel_x = -5;
	pixel_y = 3
	},
/obj/item/folder/white{
	pixel_x = -2;
	pixel_y = -12
	},
/obj/item/folder/red{
	pixel_x = -6;
	pixel_y = -12
	},
/obj/structure/window/reinforced/spawner/directional/north,
/obj/effect/turf_decal/trimline/blue/filled/line{
	dir = 9
	},
/turf/open/floor/iron/white,
/area/station/security/medical)
"J" = (
/obj/effect/turf_decal/trimline/blue/filled/line,
/turf/open/floor/iron/white,
/area/station/security/medical)
"K" = (
/obj/effect/turf_decal/tile/neutral/half/contrasted,
/obj/machinery/microwave{
	pixel_y = 5
	},
/obj/structure/table,
/turf/open/floor/iron/dark,
/area/station/security/office)
"M" = (
/obj/machinery/light/small/directional/east,
/obj/effect/turf_decal/tile/neutral,
/obj/machinery/airalarm/directional/east,
/obj/effect/turf_decal/trimline/blue/filled/line{
	dir = 4
	},
/obj/machinery/computer/operating{
	dir = 8
	},
/turf/open/floor/iron/white,
/area/station/security/medical)
"N" = (
/obj/effect/turf_decal/tile/neutral/opposingcorners,
/obj/effect/turf_decal/trimline/blue/filled/line{
	dir = 4
	},
/obj/machinery/atmospherics/pipe/smart/manifold4w/supply/hidden/layer4,
/obj/machinery/atmospherics/pipe/smart/manifold4w/scrubbers/hidden/layer2,
/obj/structure/cable,
/obj/effect/turf_decal/tile/blue{
	dir = 8
	},
/obj/structure/sink/directional/east{
	dir = 8;
	pixel_x = 15
	},
/obj/machinery/firealarm/directional/east{
	pixel_y = -5
	},
/obj/machinery/light_switch/directional/east{
	pixel_y = 5
	},
/turf/open/floor/iron/white,
/area/station/security/medical)
"O" = (
/obj/effect/turf_decal/tile/neutral,
/obj/effect/turf_decal/trimline/blue/filled/line{
	dir = 4
	},
/obj/structure/table/optable,
/obj/machinery/vitals_reader/directional/east,
/turf/open/floor/iron/white,
/area/station/security/medical)
"Q" = (
/turf/template_noop,
/area/template_noop)
"S" = (
/obj/structure/sign/departments/medbay/alt,
/turf/closed/wall,
/area/station/security/office)
"V" = (
/obj/effect/turf_decal/tile/blue{
	dir = 4
	},
/obj/machinery/atmospherics/pipe/smart/manifold4w/scrubbers/hidden/layer2,
/obj/machinery/atmospherics/pipe/smart/manifold4w/supply/hidden/layer4,
/turf/open/floor/iron/white,
/area/station/security/medical)
"W" = (
/obj/structure/sign/departments/medbay/alt,
/turf/closed/wall,
/area/station/security/medical)
"Y" = (
/obj/structure/cable,
/obj/machinery/power/apc/auto_name/directional/west,
/obj/effect/turf_decal/tile/neutral/half/contrasted{
	dir = 4
	},
/obj/machinery/stasis{
	dir = 4
	},
/obj/item/bedsheet/medical{
	dir = 4
	},
/obj/machinery/iv_drip,
/obj/effect/turf_decal/trimline/blue/filled/line{
	dir = 8
	},
/turf/open/floor/iron/white,
/area/station/security/medical)
"Z" = (
/obj/effect/turf_decal/tile/neutral/half/contrasted{
	dir = 1
	},
/obj/effect/turf_decal/trimline/red/real_red/end{
	dir = 4;
	alpha = 160
	},
/obj/structure/bodycontainer/morgue{
	dir = 8
	},
/obj/structure/window/reinforced/spawner/directional/south,
/obj/effect/turf_decal/siding/dark{
	dir = 4;
	icon_state = "siding_plain_end"
	},
/turf/open/floor/iron/dark,
/area/station/security/medical)

(1,1,1) = {"
W
h
D
D
h
t
a
"}
(2,1,1) = {"
G
m
o
Y
n
u
r
"}
(3,1,1) = {"
b
q
V
e
J
F
g
"}
(4,1,1) = {"
k
N
M
O
E
Z
K
"}
(5,1,1) = {"
s
s
s
s
s
S
Q
"}
