//MAP CONVERTED BY dmm2tgm.py THIS HEADER COMMENT PREVENTS RECONVERSION, DO NOT REMOVE
"aq" = (
/obj/machinery/atmospherics/pipe/smart/manifold4w/supply/hidden/layer4,
/obj/machinery/atmospherics/pipe/smart/manifold4w/scrubbers/hidden/layer2,
/obj/effect/turf_decal/tile/red{
	dir = 4
	},
/obj/structure/cable,
/turf/open/floor/iron,
/area/station/security/brig)
"at" = (
/turf/closed/wall,
/area/station/security/brig)
"aL" = (
/obj/machinery/atmospherics/components/unary/vent_scrubber/on/layer2{
	dir = 4
	},
/obj/structure/sink/directional/east,
/obj/structure/mirror/directional/west,
/turf/open/floor/iron/showroomfloor,
/area/station/security/medical)
"bb" = (
/turf/open/floor/iron/white,
/area/station/security/medical)
"bW" = (
/obj/machinery/atmospherics/pipe/smart/manifold4w/scrubbers/hidden/layer2,
/obj/structure/cable,
/turf/open/floor/iron/showroomfloor,
/area/station/security/medical)
"dh" = (
/obj/machinery/atmospherics/pipe/smart/manifold4w/supply/hidden/layer4,
/obj/machinery/atmospherics/pipe/smart/manifold4w/scrubbers/hidden/layer2,
/obj/structure/cable,
/turf/open/floor/iron/showroomfloor,
/area/station/security/medical)
"gj" = (
/turf/closed/wall/rust,
/area/station/maintenance/port/lesser)
"hj" = (
/turf/template_noop,
/area/template_noop)
"ho" = (
/obj/effect/turf_decal/tile/red{
	dir = 1
	},
/turf/open/floor/iron,
/area/station/security/brig)
"hZ" = (
/obj/machinery/atmospherics/pipe/smart/manifold4w/supply/hidden/layer4,
/obj/machinery/atmospherics/pipe/smart/manifold4w/scrubbers/hidden/layer2,
/obj/machinery/door/window/right/directional/north{
	req_access = list("security");
	name = "Security Infirmary"
	},
/obj/effect/turf_decal/tile/red/half/contrasted{
	dir = 4
	},
/obj/structure/cable,
/turf/open/floor/iron,
/area/station/security/medical)
"iE" = (
/obj/effect/turf_decal/tile/red/half/contrasted{
	dir = 8
	},
/obj/machinery/door/window/left/directional/north{
	req_access = list("security");
	name = "Security Infirmary"
	},
/turf/open/floor/iron,
/area/station/security/medical)
"jC" = (
/obj/effect/mapping_helpers/burnt_floor,
/obj/structure/reagent_dispensers/watertank,
/turf/open/floor/plating,
/area/station/maintenance/port/lesser)
"kb" = (
/obj/structure/table/reinforced/rglass,
/obj/machinery/light/directional/north,
/turf/open/floor/iron/white,
/area/station/security/medical)
"mF" = (
/obj/machinery/computer/operating{
	dir = 8
	},
/obj/machinery/vending/wallmed/directional/east,
/turf/open/floor/iron/white,
/area/station/security/medical)
"pH" = (
/obj/machinery/atmospherics/pipe/smart/manifold4w/scrubbers/hidden/layer2,
/obj/machinery/atmospherics/pipe/smart/manifold4w/supply/hidden/layer4,
/obj/machinery/door/window/brigdoor/right/directional/north{
	id = "Cell 4";
	name = "Cell 4 - Drunk Tank";
	req_access = list("security")
	},
/obj/structure/cable,
/turf/open/floor/iron/dark,
/area/station/security/brig)
"qy" = (
/obj/machinery/atmospherics/pipe/smart/manifold4w/supply/hidden/layer4,
/obj/machinery/atmospherics/pipe/smart/manifold4w/scrubbers/hidden/layer2,
/obj/effect/turf_decal/tile/red/half/contrasted,
/obj/effect/turf_decal/tile/neutral,
/obj/structure/cable,
/turf/open/floor/iron,
/area/station/security/brig)
"qN" = (
/obj/machinery/atmospherics/components/unary/vent_scrubber/on/layer2{
	dir = 4
	},
/obj/structure/chair/sofa/bench/left{
	dir = 4
	},
/turf/open/floor/iron,
/area/station/security/brig)
"tc" = (
/obj/structure/table/optable,
/obj/item/wallframe/defib_mount,
/turf/open/floor/iron/white,
/area/station/security/medical)
"uG" = (
/obj/machinery/atmospherics/pipe/smart/manifold4w/scrubbers/hidden/layer2,
/obj/machinery/atmospherics/pipe/smart/manifold4w/supply/hidden/layer4,
/turf/open/floor/iron,
/area/station/security/brig)
"uJ" = (
/obj/structure/chair/sofa/bench/right{
	dir = 8
	},
/turf/open/floor/iron,
/area/station/security/brig)
"uW" = (
/turf/closed/wall/r_wall,
/area/station/security/medical)
"vT" = (
/obj/structure/chair/sofa/bench{
	dir = 8
	},
/turf/open/floor/iron,
/area/station/security/brig)
"wN" = (
/turf/closed/wall,
/area/station/maintenance/port/lesser)
"yb" = (
/obj/machinery/camera/directional/east{
	c_tag = "Security Infirmary"
	},
/obj/structure/chair/sofa/bench/left{
	dir = 8
	},
/turf/open/floor/iron,
/area/station/security/brig)
"zm" = (
/obj/effect/mapping_helpers/burnt_floor,
/obj/effect/spawner/random/trash,
/obj/effect/spawner/random/trash,
/turf/open/floor/plating,
/area/station/maintenance/port/lesser)
"Am" = (
/obj/machinery/atmospherics/pipe/smart/manifold4w/supply/hidden/layer4,
/obj/machinery/atmospherics/pipe/smart/manifold4w/scrubbers/hidden/layer2,
/obj/structure/cable,
/obj/effect/landmark/event_spawn,
/turf/open/floor/iron/showroomfloor,
/area/station/security/medical)
"Be" = (
/turf/closed/wall/r_wall/rust,
/area/station/security/medical)
"Bw" = (
/obj/effect/turf_decal/tile/red/half/contrasted{
	dir = 1
	},
/turf/open/floor/iron,
/area/station/security/brig)
"BW" = (
/obj/effect/spawner/structure/window/reinforced,
/obj/machinery/door/poddoor/preopen{
	id = "brigcelldoor";
	name = "Cell Blast Door"
	},
/obj/structure/cable,
/turf/open/floor/plating,
/area/station/maintenance/port/lesser)
"Cn" = (
/obj/effect/spawner/structure/window/reinforced,
/obj/structure/cable,
/turf/open/floor/plating,
/area/station/security/brig)
"Dt" = (
/obj/effect/turf_decal/stripes/corner,
/obj/structure/table/reinforced/rglass,
/obj/item/storage/box/bandages,
/obj/item/reagent_containers/cup/bottle/epinephrine,
/obj/item/reagent_containers/syringe,
/obj/structure/window/spawner/directional/south,
/turf/open/floor/iron,
/area/station/security/medical)
"Du" = (
/obj/machinery/atmospherics/components/unary/vent_pump/on/layer4{
	dir = 1
	},
/turf/open/floor/iron,
/area/station/security/brig)
"Eb" = (
/obj/structure/table/reinforced/rglass,
/obj/item/reagent_containers/spray/cleaner{
	pixel_x = -3;
	pixel_y = 2
	},
/obj/item/healthanalyzer,
/obj/item/clothing/gloves/latex,
/obj/item/reagent_containers/spray/cleaner{
	pixel_x = 5;
	pixel_y = -1
	},
/obj/item/storage/box/bodybags,
/obj/structure/window/spawner/directional/south,
/turf/open/floor/iron,
/area/station/security/medical)
"Em" = (
/obj/structure/table/reinforced/rglass,
/obj/item/storage/portable_chem_mixer{
	pixel_x = -5;
	pixel_y = 1
	},
/obj/item/reagent_containers/cup/tube,
/obj/item/reagent_containers/cup/tube,
/obj/item/wallframe/frontier_medstation{
	pixel_x = 5;
	pixel_y = 3
	},
/turf/open/floor/iron/white,
/area/station/security/medical)
"Fl" = (
/obj/structure/table/reinforced/rglass,
/obj/item/storage/medkit/brute,
/obj/item/storage/medkit/fire{
	pixel_x = 4;
	pixel_y = 0
	},
/obj/item/storage/medkit/o2{
	pixel_x = -3;
	pixel_y = 0
	},
/obj/item/storage/medkit/regular{
	pixel_x = -4;
	pixel_y = 4
	},
/obj/item/storage/medkit/toxin{
	pixel_x = 4;
	pixel_y = 4
	},
/obj/machinery/power/apc/auto_name/directional/north,
/obj/structure/cable,
/turf/open/floor/iron/white,
/area/station/security/medical)
"Ge" = (
/obj/machinery/atmospherics/pipe/smart/manifold4w/supply/hidden/layer4,
/obj/effect/landmark/start/security_medic,
/turf/open/floor/iron/showroomfloor,
/area/station/security/medical)
"Ie" = (
/obj/machinery/wall_healer/directional/west,
/obj/structure/chair/office,
/turf/open/floor/iron/white,
/area/station/security/medical)
"IJ" = (
/turf/closed/wall,
/area/station/security/warden)
"Jo" = (
/obj/effect/mapping_helpers/burnt_floor,
/obj/effect/spawner/random/trash,
/obj/effect/spawner/random/trash/graffiti,
/turf/open/floor/plating,
/area/station/maintenance/port/lesser)
"KA" = (
/turf/closed/wall/r_wall/rust,
/area/station/maintenance/port/lesser)
"Li" = (
/obj/machinery/shower/directional/north,
/turf/open/floor/iron/white,
/area/station/security/medical)
"Lx" = (
/turf/closed/wall/rust,
/area/station/security/warden)
"Nq" = (
/obj/machinery/atmospherics/pipe/smart/manifold4w/scrubbers/hidden/layer2,
/obj/structure/cable,
/obj/effect/landmark/start/security_medic,
/turf/open/floor/iron/showroomfloor,
/area/station/security/medical)
"OC" = (
/obj/machinery/atmospherics/components/unary/vent_scrubber/on/layer2,
/obj/effect/turf_decal/tile/red/half/contrasted{
	dir = 1
	},
/obj/machinery/light/directional/north,
/turf/open/floor/iron,
/area/station/security/brig)
"Pt" = (
/obj/machinery/atmospherics/pipe/smart/manifold4w/supply/hidden/layer4,
/turf/open/floor/iron,
/area/station/security/brig)
"PJ" = (
/obj/machinery/atmospherics/components/unary/vent_pump/on/layer4{
	dir = 8
	},
/turf/open/floor/iron/showroomfloor,
/area/station/security/medical)
"Qf" = (
/obj/structure/table/reinforced/rglass,
/obj/item/storage/medkit/surgery{
	pixel_x = -2;
	pixel_y = 5
	},
/turf/open/floor/iron/white,
/area/station/security/medical)
"Ra" = (
/obj/machinery/light/small/directional/east,
/obj/structure/chair/sofa/bench{
	dir = 8
	},
/obj/machinery/airalarm/directional/east,
/turf/open/floor/iron,
/area/station/security/brig)
"Rh" = (
/obj/machinery/airalarm/directional/north,
/obj/structure/bodycontainer/morgue{
	dir = 2
	},
/obj/structure/window/spawner/directional/east,
/turf/open/floor/iron/white,
/area/station/security/medical)
"Ri" = (
/obj/structure/cable,
/obj/machinery/door/window/brigdoor/right/directional/south{
	req_access = list("security");
	name = "Cell 4 - Drunk Tank"
	},
/turf/open/floor/iron/dark,
/area/station/security/brig)
"RV" = (
/obj/structure/chair/sofa/bench{
	dir = 4
	},
/obj/structure/cable,
/turf/open/floor/iron,
/area/station/security/brig)
"RZ" = (
/obj/structure/sign/departments/medbay/alt,
/turf/closed/wall,
/area/station/security/medical)
"Tf" = (
/obj/structure/table/reinforced/rglass,
/obj/machinery/computer/records/medical/laptop{
	dir = 1
	},
/obj/item/pen,
/obj/structure/window/spawner/directional/south,
/turf/open/floor/iron,
/area/station/security/medical)
"Tl" = (
/obj/structure/bed,
/obj/item/bedsheet/medical,
/obj/machinery/iv_drip,
/turf/open/floor/iron/white,
/area/station/security/medical)
"Vm" = (
/turf/closed/wall,
/area/station/security/medical)
"Vo" = (
/obj/structure/chair/sofa/bench/right{
	dir = 4
	},
/obj/structure/cable,
/turf/open/floor/iron,
/area/station/security/brig)
"Wf" = (
/turf/open/floor/iron/showroomfloor,
/area/station/security/medical)
"Yl" = (
/obj/effect/turf_decal/tile/red{
	dir = 4
	},
/turf/open/floor/iron,
/area/station/security/brig)
"YF" = (
/obj/structure/chair/office,
/obj/structure/extinguisher_cabinet/directional/east,
/turf/open/floor/iron/white,
/area/station/security/medical)

(1,1,1) = {"
KA
jC
Jo
zm
KA
hj
hj
hj
hj
hj
hj
hj
hj
"}
(2,1,1) = {"
KA
uW
uW
uW
Be
hj
hj
hj
hj
hj
hj
hj
hj
"}
(3,1,1) = {"
wN
Rh
aL
Ie
Tf
Yl
hj
hj
hj
hj
hj
hj
hj
"}
(4,1,1) = {"
wN
Fl
Nq
Li
RZ
OC
hj
hj
hj
hj
hj
hj
hj
"}
(5,1,1) = {"
BW
Em
bW
Wf
iE
ho
hj
Cn
Cn
Cn
at
Cn
at
"}
(6,1,1) = {"
BW
Tl
Am
dh
hZ
aq
qy
Cn
qN
RV
RV
Vo
Cn
"}
(7,1,1) = {"
wN
kb
Ge
bb
RZ
Bw
hj
pH
uG
Pt
Pt
Du
Ri
"}
(8,1,1) = {"
BW
tc
PJ
bb
Eb
ho
hj
Cn
uJ
Ra
vT
yb
Cn
"}
(9,1,1) = {"
BW
Qf
mF
YF
Dt
hj
hj
IJ
IJ
IJ
Lx
IJ
IJ
"}
(10,1,1) = {"
gj
Vm
Vm
Vm
Vm
hj
hj
hj
hj
hj
hj
hj
hj
"}
