//MAP CONVERTED BY dmm2tgm.py THIS HEADER COMMENT PREVENTS RECONVERSION, DO NOT REMOVE
"a" = (
/obj/effect/turf_decal/tile/neutral/half/contrasted{
	dir = 1
	},
/obj/effect/turf_decal/trimline/red/real_red/end{
	dir = 4;
	alpha = 160
	},
/obj/machinery/power/apc/auto_name/directional/north,
/obj/structure/cable,
/turf/open/floor/iron/dark,
/area/station/security/medical)
"e" = (
/turf/closed/wall,
/area/station/security/medical)
"k" = (
/turf/closed/wall/r_wall,
/area/station/maintenance/fore)
"l" = (
/obj/effect/turf_decal/trimline/red/real_red/filled/line{
	dir = 1
	},
/obj/machinery/stasis,
/obj/item/bedsheet/medical,
/obj/machinery/iv_drip,
/obj/effect/turf_decal/siding/dark{
	dir = 1
	},
/obj/machinery/wall_healer/directional/north,
/turf/open/floor/iron/white,
/area/station/security/medical)
"q" = (
/obj/machinery/atmospherics/pipe/smart/manifold4w/supply/hidden/layer4,
/obj/effect/turf_decal/tile/red/real_red{
	dir = 8
	},
/obj/effect/turf_decal/tile/red/real_red{
	dir = 1
	},
/obj/effect/turf_decal/tile/red/real_red,
/obj/structure/cable,
/obj/effect/landmark/start/security_medic,
/turf/open/floor/iron/white,
/area/station/security/medical)
"r" = (
/obj/effect/turf_decal/tile/red/real_red{
	dir = 1
	},
/obj/machinery/door/window/brigdoor/left/directional/south{
	name = "Security Medpost"
	},
/obj/machinery/atmospherics/pipe/smart/manifold4w/scrubbers/hidden/layer2,
/obj/machinery/atmospherics/pipe/smart/manifold4w/supply/hidden/layer4,
/obj/structure/cable,
/obj/machinery/door/firedoor/border_only{
	pixel_x = 0;
	pixel_y = -1
	},
/obj/effect/turf_decal/trimline/red/real_red/filled/warning,
/obj/effect/turf_decal/siding/dark/corner,
/obj/effect/turf_decal/siding/dark/corner{
	dir = 8
	},
/turf/open/floor/iron/white,
/area/station/security/medical)
"s" = (
/turf/closed/wall/r_wall,
/area/station/command/heads_quarters/hos)
"t" = (
/obj/machinery/camera/directional/west{
	c_tag = "Security - Infirmary"
	},
/obj/machinery/light_switch/directional/west,
/obj/effect/turf_decal/trimline/red/real_red/filled/line{
	dir = 9
	},
/obj/structure/window/reinforced/spawner/directional/north{
	pixel_x = 0;
	pixel_y = 3
	},
/obj/structure/table/reinforced,
/obj/machinery/computer/records/medical/laptop{
	dir = 4;
	pixel_x = 4;
	pixel_y = 2
	},
/obj/effect/turf_decal/siding/dark{
	dir = 9
	},
/turf/open/floor/iron/white,
/area/station/security/medical)
"v" = (
/turf/closed/wall/r_wall,
/area/station/security/medical)
"w" = (
/obj/effect/turf_decal/trimline/red/real_red/filled/line{
	dir = 5
	},
/obj/effect/spawner/surgery_tray/full,
/obj/structure/table/reinforced/rglass,
/obj/effect/turf_decal/siding/dark{
	dir = 5
	},
/obj/item/radio/intercom/directional/north,
/obj/structure/sign/poster/official/cleanliness/directional/east,
/turf/open/floor/iron/white,
/area/station/security/medical)
"z" = (
/obj/effect/turf_decal/trimline/red/real_red/filled/line{
	dir = 4
	},
/obj/structure/table/optable,
/obj/machinery/firealarm/directional/east,
/obj/effect/turf_decal/siding/dark{
	dir = 4
	},
/obj/structure/sink/directional/south,
/turf/open/floor/iron/white,
/area/station/security/medical)
"C" = (
/obj/structure/window/reinforced/spawner/directional/south,
/obj/effect/turf_decal/trimline/red/real_red/filled/line,
/obj/structure/table/reinforced,
/obj/machinery/computer/crew{
	dir = 1
	},
/obj/effect/turf_decal/siding/dark,
/turf/open/floor/iron/white,
/area/station/security/medical)
"D" = (
/obj/effect/turf_decal/tile/neutral/fourcorners,
/obj/effect/turf_decal/trimline/red/real_red/end{
	dir = 8;
	alpha = 160
	},
/obj/structure/bodycontainer/morgue,
/obj/structure/sign/poster/official/moth_epi/directional/north,
/turf/open/floor/iron/dark,
/area/station/security/medical)
"I" = (
/obj/structure/cable,
/obj/effect/turf_decal/trimline/red/real_red/filled/line{
	dir = 1
	},
/obj/effect/turf_decal/siding/dark{
	dir = 1
	},
/obj/effect/landmark/start/security_medic,
/obj/structure/chair/office{
	dir = 8
	},
/turf/open/floor/iron/white,
/area/station/security/medical)
"L" = (
/obj/machinery/light/cold/directional/north,
/obj/structure/closet/secure_closet/security_medic,
/obj/effect/turf_decal/trimline/red/real_red/filled/line{
	dir = 9
	},
/obj/structure/window/reinforced/spawner/directional/west{
	pixel_x = -3;
	pixel_y = 0
	},
/obj/item/storage/medkit/regular{
	pixel_x = 0;
	pixel_y = 0
	},
/obj/item/storage/box/bodybags,
/obj/item/reagent_containers/syringe{
	name = "steel point"
	},
/obj/machinery/atmospherics/components/unary/vent_pump/on/layer4,
/obj/item/clothing/mask/surgical,
/obj/item/clothing/gloves/latex,
/obj/effect/turf_decal/siding/dark{
	dir = 9
	},
/obj/machinery/airalarm/directional/north,
/turf/open/floor/iron/white,
/area/station/security/medical)
"R" = (
/obj/structure/window/reinforced/spawner/directional/south,
/obj/effect/turf_decal/trimline/red/real_red/filled/line{
	dir = 10
	},
/obj/structure/table/reinforced,
/obj/item/folder/red{
	pixel_x = 7;
	pixel_y = 1
	},
/obj/item/folder/white{
	pixel_x = 11;
	pixel_y = 1
	},
/obj/item/paper_bin{
	pixel_x = -7;
	pixel_y = 3
	},
/obj/item/pen{
	pixel_x = -8;
	pixel_y = 5
	},
/obj/item/reagent_containers/cup/glass/mug/nanotrasen{
	pixel_x = 9;
	pixel_y = 16
	},
/obj/item/healthanalyzer{
	pixel_x = -7;
	pixel_y = 20
	},
/obj/effect/turf_decal/siding/dark{
	dir = 10
	},
/turf/open/floor/iron/white,
/area/station/security/medical)
"U" = (
/obj/structure/window/reinforced/spawner/directional/south,
/obj/effect/turf_decal/trimline/red/real_red/filled/line{
	dir = 6
	},
/obj/machinery/computer/operating{
	dir = 8
	},
/obj/machinery/atmospherics/components/unary/vent_scrubber/on/layer2{
	dir = 8
	},
/obj/effect/turf_decal/siding/dark{
	dir = 6
	},
/obj/structure/extinguisher_cabinet/directional/east,
/turf/open/floor/iron/white,
/area/station/security/medical)
"W" = (
/obj/machinery/atmospherics/pipe/smart/manifold4w/supply/hidden/layer4,
/obj/structure/cable,
/obj/effect/landmark/event_spawn,
/obj/effect/turf_decal/tile/red/real_red,
/obj/effect/turf_decal/trimline/red/real_red/filled/corner{
	dir = 1
	},
/obj/machinery/holopad,
/obj/effect/turf_decal/siding/dark/corner{
	dir = 1
	},
/turf/open/floor/iron/white,
/area/station/security/medical)
"Z" = (
/obj/effect/turf_decal/trimline/red/real_red/filled/line,
/obj/structure/window/reinforced/spawner/directional/south,
/obj/structure/table/reinforced,
/obj/item/reagent_containers/spray/cleaner{
	pixel_x = -12;
	pixel_y = 17
	},
/obj/item/reagent_containers/cup/bottle/epinephrine{
	pixel_x = 8;
	pixel_y = 14
	},
/obj/item/reagent_containers/cup/bottle/multiver{
	pixel_x = -1;
	pixel_y = 14
	},
/obj/item/reagent_containers/syringe{
	pixel_x = 4;
	pixel_y = 3
	},
/obj/item/storage/box/bandages{
	pixel_x = -11;
	pixel_y = 1
	},
/obj/effect/turf_decal/siding/dark,
/turf/open/floor/iron/white,
/area/station/security/medical)

(1,1,1) = {"
s
e
e
e
"}
(2,1,1) = {"
s
D
t
R
"}
(3,1,1) = {"
k
a
I
C
"}
(4,1,1) = {"
k
L
W
Z
"}
(5,1,1) = {"
k
l
q
r
"}
(6,1,1) = {"
k
w
z
U
"}
(7,1,1) = {"
k
v
v
v
"}
