//MAP CONVERTED BY dmm2tgm.py THIS HEADER COMMENT PREVENTS RECONVERSION, DO NOT REMOVE
"a" = (
/turf/closed/wall/r_wall,
/area/space)
"c" = (
/obj/effect/turf_decal/siding/wood{
	dir = 1
	},
/obj/effect/turf_decal/siding/wood,
/obj/machinery/atmospherics/pipe/smart/manifold4w/scrubbers/hidden/layer2,
/obj/machinery/atmospherics/pipe/smart/manifold4w/supply/hidden/layer4,
/obj/structure/cable,
/turf/open/floor/wood/parquet,
/area/space)
"f" = (
/obj/effect/turf_decal/siding/thinplating_new/dark{
	dir = 1
	},
/obj/machinery/firealarm/directional/south,
/obj/structure/rack/shelf,
/obj/item/storage/medkit/brute,
/obj/item/storage/medkit/fire{
	pixel_y = 4
	},
/turf/open/floor/iron/dark/small,
/area/space)
"i" = (
/obj/effect/turf_decal/tile/neutral/fourcorners,
/obj/effect/spawner/random/vending/colavend,
/turf/open/floor/iron/dark,
/area/space)
"j" = (
/obj/structure/closet/secure_closet/tac{
	req_access = list("captain")
	},
/obj/effect/turf_decal/siding/thinplating_new/dark,
/obj/structure/sign/poster/official/nanotrasen_logo/directional/west,
/obj/structure/cable,
/obj/machinery/power/apc/auto_name/directional/north,
/obj/item/clothing/suit/armor/riot,
/obj/item/clothing/head/helmet/toggleable/riot,
/turf/open/floor/iron/dark/small,
/area/space)
"m" = (
/obj/structure/closet/secure_closet/blueshield,
/obj/effect/turf_decal/siding/thinplating_new/dark,
/obj/machinery/airalarm/directional/north,
/turf/open/floor/iron/dark/small,
/area/space)
"n" = (
/obj/effect/turf_decal/siding/wood{
	dir = 10
	},
/obj/effect/turf_decal/siding/wood/corner{
	dir = 4
	},
/obj/machinery/firealarm/directional/west,
/obj/machinery/atmospherics/pipe/smart/manifold4w/scrubbers/hidden/layer2,
/obj/machinery/atmospherics/pipe/smart/manifold4w/supply/hidden/layer4,
/obj/structure/table/wood/fancy/blue,
/obj/item/reagent_containers/cup/glass/bottle/champagne{
	pixel_y = 19;
	pixel_x = -4
	},
/obj/item/reagent_containers/cup/glass/drinkingglass/shotglass{
	pixel_y = 7;
	pixel_x = 7
	},
/obj/item/reagent_containers/cup/glass/drinkingglass/shotglass{
	pixel_y = 2;
	pixel_x = -1
	},
/turf/open/floor/wood/parquet,
/area/space)
"o" = (
/obj/machinery/computer/crew,
/obj/machinery/newscaster/directional/east,
/turf/open/floor/carpet/blue,
/area/space)
"q" = (
/obj/effect/turf_decal/tile/blue/diagonal_centre,
/obj/machinery/status_display/ai/directional/west,
/obj/machinery/light/red/directional/west,
/obj/machinery/atmospherics/components/unary/vent_pump/on/layer4{
	dir = 4
	},
/obj/structure/cable,
/obj/machinery/camera/autoname/directional/west,
/turf/open/floor/iron/dark/diagonal,
/area/space)
"r" = (
/obj/effect/turf_decal/siding/wood{
	dir = 1
	},
/obj/effect/turf_decal/siding/wood,
/obj/machinery/atmospherics/pipe/smart/manifold4w/scrubbers/hidden/layer2,
/obj/machinery/atmospherics/pipe/smart/manifold4w/supply/hidden/layer4,
/obj/structure/chair/comfy/brown{
	dir = 8
	},
/turf/open/floor/wood/parquet,
/area/space)
"y" = (
/obj/effect/turf_decal/tile/neutral/fourcorners,
/obj/effect/spawner/random/vending/snackvend,
/obj/structure/sign/departments/court/directional/west,
/turf/open/floor/iron/dark,
/area/space)
"B" = (
/obj/machinery/door/airlock/highsecurity{
	name = "Blueshield's Armory"
	},
/obj/effect/mapping_helpers/airlock/access/all/command/captain,
/obj/machinery/door/firedoor,
/obj/machinery/atmospherics/pipe/smart/manifold4w/scrubbers/hidden/layer2,
/obj/machinery/atmospherics/pipe/smart/manifold4w/supply/hidden/layer4,
/obj/structure/cable,
/turf/open/floor/iron/dark/smooth_large,
/area/space)
"C" = (
/obj/machinery/status_display/evac/directional/east,
/obj/machinery/light/directional/east,
/obj/machinery/camera/autoname/directional/east,
/obj/structure/table/reinforced/titaniumglass,
/obj/item/paper_bin{
	pixel_y = 5;
	pixel_x = -4
	},
/obj/item/stamp{
	pixel_y = 10;
	pixel_x = 8
	},
/obj/item/stamp/denied{
	pixel_x = 8;
	pixel_y = 3
	},
/obj/item/pen/fountain/nanotrasen{
	pixel_y = 5;
	pixel_x = -4
	},
/turf/open/floor/carpet/blue,
/area/space)
"D" = (
/obj/structure/hedge,
/obj/effect/turf_decal/siding/wood/end{
	dir = 1
	},
/obj/structure/sign/clock/directional/north,
/obj/machinery/atmospherics/components/unary/vent_scrubber/on/layer2,
/obj/machinery/airalarm/directional/west,
/turf/open/floor/wood/parquet,
/area/space)
"E" = (
/obj/machinery/modular_computer/preset/command,
/obj/structure/cable,
/turf/open/floor/carpet/blue,
/area/space)
"F" = (
/obj/structure/chair/comfy/black{
	dir = 1
	},
/obj/effect/landmark/start/blueshield,
/obj/structure/cable,
/turf/open/floor/carpet/blue,
/area/space)
"H" = (
/obj/effect/turf_decal/siding/wood{
	dir = 4
	},
/obj/effect/turf_decal/siding/wood{
	dir = 8
	},
/obj/structure/extinguisher_cabinet/directional/west,
/obj/machinery/light/directional/west,
/obj/machinery/atmospherics/pipe/smart/manifold4w/scrubbers/hidden/layer2,
/obj/machinery/atmospherics/pipe/smart/manifold4w/supply/hidden/layer4,
/obj/structure/chair/comfy/brown,
/turf/open/floor/wood/parquet,
/area/space)
"I" = (
/obj/effect/turf_decal/siding/wood/end{
	dir = 4
	},
/obj/machinery/light_switch/directional/east,
/obj/machinery/atmospherics/components/unary/vent_pump/on/layer4{
	dir = 8
	},
/obj/structure/grandfatherclock,
/turf/open/floor/wood/parquet,
/area/space)
"J" = (
/obj/effect/turf_decal/siding/thinplating_new/dark{
	dir = 1
	},
/obj/structure/rack/shelf,
/obj/item/storage/toolbox/ammobox/wt550m9,
/obj/structure/sign/poster/official/enlist/directional/west,
/turf/open/floor/iron/dark/small,
/area/space)
"K" = (
/obj/effect/spawner/structure/window/reinforced,
/obj/machinery/door/poddoor/shutters/preopen{
	id = "blueshield_priv";
	name = "Privacy Shutters"
	},
/obj/structure/cable,
/turf/open/floor/plating,
/area/space)
"O" = (
/obj/machinery/computer/security,
/obj/item/sign/flag/nanotrasen{
	pixel_y = 18
	},
/turf/open/floor/carpet/blue,
/area/space)
"R" = (
/obj/structure/cable,
/turf/open/floor/carpet/blue,
/area/space)
"S" = (
/obj/structure/table/reinforced/titaniumglass,
/obj/machinery/recharger{
	pixel_y = 3;
	pixel_x = -6
	},
/obj/machinery/button/door/directional/east{
	id = "blueshield_priv";
	req_access = list("captain");
	name = "Privacy Shutters Control"
	},
/obj/item/folder/blue{
	pixel_y = 17;
	pixel_x = -4
	},
/obj/item/flashlight/lamp/green{
	pixel_y = 14;
	pixel_x = 5
	},
/obj/item/phone{
	pixel_x = 8;
	pixel_y = -1
	},
/turf/open/floor/carpet/blue,
/area/space)
"U" = (
/obj/machinery/door/airlock/corporate{
	name = "Blueshield's Office"
	},
/obj/effect/mapping_helpers/airlock/access/all/command/captain,
/obj/machinery/door/firedoor,
/obj/machinery/atmospherics/pipe/smart/manifold4w/scrubbers/hidden/layer2,
/obj/machinery/atmospherics/pipe/smart/manifold4w/supply/hidden/layer4,
/obj/structure/cable,
/obj/effect/landmark/navigate_destination/autoname,
/turf/open/floor/iron/dark/smooth_large,
/area/space)
"V" = (
/obj/effect/turf_decal/tile/blue/diagonal_centre,
/obj/machinery/atmospherics/components/unary/vent_scrubber/on/layer2{
	dir = 4
	},
/obj/machinery/atmospherics/pipe/smart/manifold4w/supply/hidden/layer4,
/obj/structure/cable,
/obj/effect/landmark/start/blueshield,
/turf/open/floor/iron/dark/diagonal,
/area/space)
"W" = (
/obj/effect/spawner/structure/window/reinforced,
/obj/machinery/door/poddoor/shutters/preopen{
	id = "blueshield_priv";
	name = "Privacy Shutters";
	dir = 1
	},
/obj/structure/cable,
/turf/open/floor/plating,
/area/space)
"Y" = (
/obj/effect/turf_decal/siding/wood{
	dir = 4
	},
/obj/effect/turf_decal/siding/wood{
	dir = 8
	},
/obj/machinery/atmospherics/pipe/smart/manifold4w/scrubbers/hidden/layer2,
/obj/machinery/atmospherics/pipe/smart/manifold4w/supply/hidden/layer4,
/obj/structure/cable,
/turf/open/floor/wood/parquet,
/area/space)
"Z" = (
/obj/machinery/holopad,
/turf/open/floor/carpet/blue,
/area/space)

(1,1,1) = {"
a
a
a
a
a
a
"}
(2,1,1) = {"
a
j
q
J
a
y
"}
(3,1,1) = {"
a
m
V
f
a
i
"}
(4,1,1) = {"
a
a
B
a
a
a
"}
(5,1,1) = {"
a
D
Y
H
n
K
"}
(6,1,1) = {"
W
O
R
Z
r
K
"}
(7,1,1) = {"
W
E
F
R
c
U
"}
(8,1,1) = {"
W
o
C
S
I
K
"}
(9,1,1) = {"
a
a
a
a
a
a
"}
