//MAP CONVERTED BY dmm2tgm.py THIS HEADER COMMENT PREVENTS RECONVERSION, DO NOT REMOVE
"aL" = (
/turf/open/floor/iron/stairs/medium{
	dir = 8
	},
/area/station/security/medical)
"bb" = (
/obj/machinery/atmospherics/pipe/smart/manifold4w/supply/hidden/layer4,
/obj/machinery/wall_healer/directional/east,
/obj/effect/turf_decal/tile/red/half{
	dir = 4
	},
/obj/structure/chair/office{
	dir = 1
	},
/obj/effect/landmark/start/security_medic,
/turf/open/floor/iron/white/textured,
/area/station/security/medical)
"bW" = (
/obj/effect/turf_decal/tile/red/real_red/anticorner{
	dir = 8
	},
/obj/structure/sign/poster/official/enlist/directional/south,
/obj/machinery/atmospherics/components/unary/vent_scrubber/on/layer2{
	dir = 1
	},
/obj/machinery/power/apc/auto_name/directional/west,
/obj/structure/cable,
/turf/open/floor/iron/dark/textured,
/area/station/security/medical)
"dh" = (
/turf/closed/wall,
/area/station/security/prison/safe)
"hj" = (
/turf/template_noop,
/area/template_noop)
"hZ" = (
/turf/closed/wall,
/area/station/security/medical)
"ik" = (
/obj/machinery/atmospherics/pipe/smart/manifold4w/scrubbers/hidden/layer2,
/obj/machinery/atmospherics/pipe/smart/manifold4w/supply/hidden/layer4,
/obj/structure/cable,
/obj/effect/landmark/event_spawn,
/obj/effect/turf_decal/tile/red/diagonal_centre,
/turf/open/floor/iron/dark/textured_half,
/area/station/security/medical)
"iE" = (
/turf/open/space/basic,
/area/station/security/medical)
"kb" = (
/obj/machinery/atmospherics/pipe/smart/manifold4w/supply/hidden/layer4,
/turf/open/floor/iron/white/textured,
/area/station/security/medical)
"pH" = (
/obj/structure/table/optable,
/obj/machinery/light/directional/east,
/obj/effect/turf_decal/tile/red/real_red/anticorner{
	dir = 4
	},
/obj/item/wallframe/defib_mount,
/obj/structure/sign/poster/official/corporate_perks_vacation/directional/north,
/turf/open/floor/iron/dark/textured,
/area/station/security/medical)
"qN" = (
/obj/machinery/atmospherics/pipe/multiz/scrubbers/visible/layer2,
/obj/machinery/atmospherics/pipe/multiz/supply/visible/layer4,
/obj/structure/sign/poster/contraband/random/directional/north,
/obj/machinery/door/window/right,
/obj/effect/turf_decal/shuttle/exploration/hazardstripe{
	dir = 3
	},
/turf/open/floor/plating,
/area/station/security/prison/safe)
"tc" = (
/obj/structure/window/reinforced/spawner/directional/west,
/obj/effect/turf_decal/tile/red/real_red/half{
	dir = 3
	},
/obj/structure/chair/pillow_small,
/obj/item/toy/plush/snakeplushie{
	name = "snek med plushie";
	desc = "An adorable stuffed toy that resembles a snake. This one comes with 3 years of med school debt and a tiny plastic badge."
	},
/turf/open/floor/iron/dark/textured,
/area/station/security/medical)
"uG" = (
/turf/closed/wall/r_wall,
/area/station/security/prison/safe)
"uJ" = (
/turf/closed/wall/r_wall,
/area/station/security/medical)
"uW" = (
/turf/closed/wall/r_wall,
/area/template_noop)
"vT" = (
/obj/machinery/atmospherics/pipe/smart/manifold4w/supply/hidden/layer4,
/obj/structure/cable,
/obj/machinery/atmospherics/pipe/smart/manifold4w/scrubbers/hidden/layer2,
/obj/structure/railing,
/obj/effect/turf_decal/tile/red/real_red/half{
	dir = 1
	},
/turf/open/floor/iron/dark/textured,
/area/station/security/medical)
"wN" = (
/obj/structure/stairs/east,
/turf/open/floor/iron/stairs/medium{
	dir = 8
	},
/area/station/security/medical)
"Am" = (
/obj/machinery/airalarm/directional/north,
/obj/machinery/atmospherics/components/unary/vent_pump/on/layer4,
/obj/effect/turf_decal/tile/red/anticorner{
	dir = 4
	},
/obj/effect/turf_decal/tile/red/anticorner{
	dir = 4
	},
/obj/structure/table/glass,
/obj/machinery/computer/records/medical/laptop,
/turf/open/floor/iron/white/textured,
/area/station/security/medical)
"Bw" = (
/obj/structure/cable/multilayer/multiz,
/obj/structure/sign/warning/electric_shock/directional/north,
/obj/machinery/door/window/left,
/obj/effect/turf_decal/shuttle/exploration/hazardstripe{
	dir = 3
	},
/obj/item/toy/plush/toaste_plushy{
	pixel_x = 14;
	pixel_y = 0
	},
/obj/item/clothing/head/utility/hardhat{
	pixel_x = 17;
	pixel_y = 11
	},
/obj/item/flashlight{
	pixel_x = -1;
	pixel_y = 0
	},
/turf/open/floor/plating,
/area/station/security/prison/safe)
"BW" = (
/obj/item/storage/medkit/regular{
	pixel_x = 3;
	pixel_y = 3
	},
/obj/structure/table/glass,
/obj/structure/window/reinforced/spawner/directional/south,
/obj/machinery/firealarm/directional/east,
/obj/item/storage/medkit/brute,
/obj/item/storage/medkit/fire,
/obj/item/storage/medkit/o2,
/obj/item/storage/medkit/toxin,
/obj/effect/turf_decal/tile/red/anticorner,
/obj/effect/turf_decal/tile/red/anticorner,
/turf/open/floor/iron/white/textured,
/area/station/security/medical)
"Dt" = (
/obj/machinery/door/firedoor/border_only,
/obj/machinery/door/window/brigdoor/left/directional/south{
	name = "Security Medpost"
	},
/obj/machinery/atmospherics/pipe/smart/manifold4w/supply/hidden/layer4,
/obj/machinery/atmospherics/pipe/smart/manifold4w/scrubbers/hidden/layer2,
/obj/structure/cable,
/obj/structure/railing/corner/end{
	dir = 8
	},
/turf/open/floor/iron/white/textured,
/area/station/security/medical)
"Eb" = (
/obj/machinery/camera/directional/west{
	c_tag = "Security - Infirmary"
	},
/obj/machinery/light_switch/directional/west,
/obj/machinery/atmospherics/components/unary/vent_scrubber/on/layer2{
	dir = 4
	},
/obj/structure/rack,
/obj/item/healthanalyzer,
/obj/item/storage/box/bandages{
	pixel_x = -6;
	pixel_y = 6
	},
/obj/item/storage/portable_chem_mixer,
/obj/item/reagent_containers/cup/tube,
/obj/item/reagent_containers/cup/tube,
/obj/structure/railing,
/obj/effect/turf_decal/tile/red/anticorner{
	dir = 1
	},
/obj/effect/turf_decal/tile/red/anticorner{
	dir = 1
	},
/turf/open/floor/iron/white/textured,
/area/station/security/medical)
"Em" = (
/obj/structure/cable,
/obj/machinery/atmospherics/pipe/smart/manifold4w/supply/hidden/layer4,
/obj/machinery/atmospherics/pipe/smart/manifold4w/scrubbers/hidden/layer2,
/obj/structure/bed/medical,
/obj/item/clothing/suit/jacket/straight_jacket,
/obj/effect/turf_decal/shuttle/exploration/hazardstripe{
	dir = 1
	},
/turf/open/floor/iron/dark/textured,
/area/station/security/medical)
"Fl" = (
/obj/machinery/atmospherics/pipe/smart/manifold4w/supply/hidden/layer4,
/obj/structure/cable,
/obj/machinery/atmospherics/pipe/smart/manifold4w/scrubbers/hidden/layer2,
/obj/effect/turf_decal/tile/red/real_red{
	dir = 1
	},
/turf/open/floor/iron/dark/textured,
/area/station/security/medical)
"Li" = (
/obj/item/radio/intercom/directional/north,
/obj/effect/turf_decal/tile/red/half{
	dir = 1
	},
/obj/item/reagent_containers/blood,
/obj/machinery/iv_drip,
/turf/open/floor/iron/white/textured,
/area/station/security/medical)
"Lx" = (
/obj/machinery/light/cold/directional/north,
/obj/machinery/atmospherics/pipe/smart/manifold4w/scrubbers/hidden/layer2,
/obj/structure/cable,
/obj/structure/railing/corner/end/flip{
	dir = 8
	},
/obj/effect/turf_decal/tile/red/half{
	dir = 1
	},
/obj/machinery/biogenerator/medstation/directional/north,
/turf/open/floor/iron/white/textured,
/area/station/security/medical)
"Nf" = (
/obj/effect/turf_decal/tile/red/real_red{
	dir = 4
	},
/obj/machinery/atmospherics/components/unary/vent_pump/on/layer4{
	dir = 8
	},
/obj/effect/landmark/start/security_medic,
/turf/open/floor/iron/dark/textured,
/area/station/security/medical)
"Nq" = (
/obj/machinery/computer/operating{
	dir = 8
	},
/obj/effect/turf_decal/tile/red/real_red/anticorner{
	dir = 0
	},
/turf/open/floor/iron/dark/textured,
/area/station/security/medical)
"OC" = (
/obj/item/storage/box/bodybags,
/obj/item/reagent_containers/syringe{
	name = "steel point"
	},
/obj/item/reagent_containers/cup/bottle/multiver,
/obj/item/reagent_containers/cup/bottle/epinephrine,
/obj/structure/table/glass,
/obj/structure/window/reinforced/spawner/directional/south,
/obj/structure/railing{
	dir = 1
	},
/obj/effect/turf_decal/tile/red/anticorner{
	dir = 8
	},
/obj/effect/turf_decal/tile/red/anticorner{
	dir = 8
	},
/turf/open/floor/iron/white/textured,
/area/station/security/medical)
"PJ" = (
/obj/machinery/atmospherics/pipe/smart/manifold4w/supply/hidden/layer4,
/obj/structure/cable,
/obj/machinery/atmospherics/pipe/smart/manifold4w/scrubbers/hidden/layer2,
/obj/structure/railing,
/obj/effect/turf_decal/tile/red/real_red/half{
	dir = 1
	},
/obj/machinery/airalarm/directional/north,
/turf/open/floor/iron/dark/textured,
/area/station/security/medical)
"PR" = (
/obj/structure/window/reinforced/spawner/directional/south,
/obj/machinery/holopad,
/obj/structure/bed/medical/emergency,
/obj/structure/railing{
	dir = 1
	},
/obj/effect/turf_decal/tile/red/half,
/turf/open/floor/iron/white/textured,
/area/station/security/medical)
"RZ" = (
/obj/machinery/atmospherics/pipe/smart/manifold4w/scrubbers/hidden/layer2,
/obj/structure/cable,
/obj/machinery/atmospherics/pipe/smart/manifold4w/scrubbers/hidden/layer2,
/obj/structure/railing,
/obj/machinery/power/apc/auto_name/directional/north,
/obj/effect/turf_decal/tile/red/half{
	dir = 1
	},
/turf/open/floor/iron/white/textured,
/area/station/security/medical)
"Vo" = (
/obj/effect/turf_decal/tile/red/real_red/half{
	dir = 3
	},
/turf/open/floor/iron/dark/textured,
/area/station/security/medical)
"Wf" = (
/obj/structure/cable,
/obj/machinery/atmospherics/pipe/smart/manifold4w/supply/hidden/layer4,
/obj/machinery/atmospherics/pipe/smart/manifold4w/scrubbers/hidden/layer2,
/obj/effect/mapping_helpers/airlock/access/all/security/brig,
/obj/machinery/door/airlock/security/glass{
	name = "Security Medbay"
	},
/turf/open/floor/plating,
/area/station/security/medical)
"Ye" = (
/obj/machinery/atmospherics/pipe/smart/manifold4w/supply/hidden/layer4,
/obj/machinery/atmospherics/pipe/smart/manifold4w/scrubbers/hidden/layer2,
/obj/effect/turf_decal/shuttle/exploration/hazardstripe{
	dir = 1
	},
/obj/structure/closet/secure_closet/security_medic,
/obj/item/storage/medkit/surgery,
/turf/open/floor/iron/dark/textured,
/area/station/security/medical)
"Yl" = (
/obj/structure/cable,
/obj/machinery/atmospherics/pipe/smart/manifold4w/supply/hidden/layer4,
/obj/machinery/atmospherics/pipe/smart/manifold4w/scrubbers/hidden/layer2,
/obj/structure/railing/corner/end{
	dir = 4
	},
/obj/effect/turf_decal/tile/red/real_red/anticorner{
	dir = 1
	},
/turf/open/floor/iron/dark/textured,
/area/station/security/medical)
"YF" = (
/obj/item/clothing/gloves/latex,
/obj/item/clothing/mask/surgical,
/obj/item/reagent_containers/spray/cleaner,
/obj/structure/table/glass,
/obj/structure/window/reinforced/spawner/directional/south,
/obj/effect/turf_decal/tile/red/half,
/turf/open/floor/iron/white/textured,
/area/station/security/medical)

(1,1,1) = {"
hj
hj
uJ
Wf
uJ
uW
"}
(2,1,1) = {"
hj
hj
hZ
Yl
bW
uW
"}
(3,1,1) = {"
hj
hj
hZ
vT
aL
uW
"}
(4,1,1) = {"
dh
dh
hZ
PJ
wN
uW
"}
(5,1,1) = {"
dh
Bw
Em
Fl
tc
uW
"}
(6,1,1) = {"
dh
qN
Ye
Nf
Vo
uW
"}
(7,1,1) = {"
uG
uG
uJ
pH
Nq
uW
"}
(8,1,1) = {"
hj
hj
uJ
uJ
uJ
uW
"}

(1,1,2) = {"
hj
hj
hj
hj
hj
hj
"}
(2,1,2) = {"
hj
hj
uW
hZ
hZ
hZ
"}
(3,1,2) = {"
hj
hj
uW
Eb
iE
OC
"}
(4,1,2) = {"
hj
hj
uW
RZ
iE
PR
"}
(5,1,2) = {"
hj
hj
uW
Lx
ik
Dt
"}
(6,1,2) = {"
hj
hj
uW
Li
kb
YF
"}
(7,1,2) = {"
hj
hj
uW
Am
bb
BW
"}
(8,1,2) = {"
hj
hj
uW
uJ
uJ
uJ
"}
