//MAP CONVERTED BY dmm2tgm.py THIS HEADER COMMENT PREVENTS RECONVERSION, DO NOT REMOVE
"aL" = (
/turf/open/floor/iron/stairs/medium{
	dir = 8
	},
/area/station/security/medical)
"bW" = (
/obj/effect/turf_decal/tile/red/real_red/anticorner{
	dir = 8
	},
/obj/structure/sign/poster/official/enlist/directional/south,
/obj/machinery/atmospherics/components/unary/vent_scrubber/on/layer2{
	dir = 1
	},
/obj/machinery/light/small/directional/west,
/turf/open/floor/iron/dark/textured,
/area/station/security/medical)
"dh" = (
/turf/closed/wall,
/area/station/security/prison/safe)
"hj" = (
/turf/template_noop,
/area/template_noop)
"hZ" = (
/turf/closed/wall,
/area/station/security/medical)
"pH" = (
/obj/structure/table/optable,
/obj/machinery/light/directional/east,
/obj/effect/turf_decal/tile/red/real_red/anticorner{
	dir = 4
	},
/obj/item/wallframe/defib_mount,
/obj/structure/sign/poster/official/corporate_perks_vacation/directional/north,
/obj/item/storage/medkit/surgery,
/turf/open/floor/iron/dark/textured,
/area/station/security/medical)
"qN" = (
/obj/machinery/atmospherics/pipe/multiz/scrubbers/visible/layer2,
/obj/machinery/atmospherics/pipe/multiz/supply/visible/layer4,
/obj/structure/sign/poster/contraband/random/directional/north,
/obj/effect/turf_decal/shuttle/exploration/hazardstripe{
	dir = 3
	},
/obj/machinery/door/window/left/directional/south,
/turf/open/floor/plating,
/area/station/security/prison/safe)
"tc" = (
/obj/structure/window/reinforced/spawner/directional/west,
/obj/effect/turf_decal/tile/red/real_red/half{
	dir = 3
	},
/obj/structure/chair/pillow_small,
/obj/item/toy/plush/snakeplushie{
	name = "snek med plushie";
	desc = "An adorable stuffed toy that resembles a snake. This one comes with 3 years of med school debt and a tiny plastic badge."
	},
/turf/open/floor/iron/dark/textured,
/area/station/security/medical)
"uG" = (
/turf/closed/wall/r_wall,
/area/station/security/prison/safe)
"uJ" = (
/turf/closed/wall/r_wall,
/area/station/security/medical)
"uW" = (
/turf/closed/wall/r_wall,
/area/station/security/execution/education)
"vT" = (
/obj/machinery/atmospherics/pipe/smart/manifold4w/supply/hidden/layer4,
/obj/structure/cable,
/obj/machinery/atmospherics/pipe/smart/manifold4w/scrubbers/hidden/layer2,
/obj/structure/railing,
/obj/effect/turf_decal/tile/red/real_red/half{
	dir = 1
	},
/turf/open/floor/iron/dark/textured,
/area/station/security/medical)
"wN" = (
/obj/structure/stairs/east,
/turf/open/floor/iron/stairs/medium{
	dir = 8
	},
/area/station/security/medical)
"Bw" = (
/obj/structure/cable/multilayer/multiz,
/obj/structure/sign/warning/electric_shock/directional/north,
/obj/effect/turf_decal/shuttle/exploration/hazardstripe{
	dir = 3
	},
/obj/machinery/door/window/right/directional/south,
/turf/open/floor/plating,
/area/station/security/prison/safe)
"Em" = (
/obj/structure/cable,
/obj/machinery/atmospherics/pipe/smart/manifold4w/supply/hidden/layer4,
/obj/machinery/atmospherics/pipe/smart/manifold4w/scrubbers/hidden/layer2,
/obj/structure/bed/medical,
/obj/item/clothing/suit/jacket/straight_jacket,
/obj/effect/turf_decal/shuttle/exploration/hazardstripe{
	dir = 1
	},
/turf/open/floor/iron/dark/textured,
/area/station/security/medical)
"Fl" = (
/obj/machinery/atmospherics/pipe/smart/manifold4w/supply/hidden/layer4,
/obj/structure/cable,
/obj/machinery/atmospherics/pipe/smart/manifold4w/scrubbers/hidden/layer2,
/obj/effect/turf_decal/tile/red/real_red{
	dir = 1
	},
/turf/open/floor/iron/dark/textured,
/area/station/security/medical)
"Nf" = (
/obj/effect/turf_decal/tile/red/real_red{
	dir = 4
	},
/obj/machinery/atmospherics/components/unary/vent_pump/on/layer4{
	dir = 8
	},
/obj/effect/landmark/start/security_medic,
/turf/open/floor/iron/dark/textured,
/area/station/security/medical)
"Nq" = (
/obj/machinery/computer/operating{
	dir = 8
	},
/obj/effect/turf_decal/tile/red/real_red/anticorner{
	dir = 0
	},
/turf/open/floor/iron/dark/textured,
/area/station/security/medical)
"PJ" = (
/obj/machinery/atmospherics/pipe/smart/manifold4w/supply/hidden/layer4,
/obj/structure/cable,
/obj/machinery/atmospherics/pipe/smart/manifold4w/scrubbers/hidden/layer2,
/obj/structure/railing,
/obj/effect/turf_decal/tile/red/real_red/half{
	dir = 1
	},
/obj/machinery/airalarm/directional/north,
/turf/open/floor/iron/dark/textured,
/area/station/security/medical)
"Vo" = (
/obj/effect/turf_decal/tile/red/real_red/half{
	dir = 3
	},
/turf/open/floor/iron/dark/textured,
/area/station/security/medical)
"Wf" = (
/obj/structure/cable,
/obj/machinery/atmospherics/pipe/smart/manifold4w/supply/hidden/layer4,
/obj/machinery/atmospherics/pipe/smart/manifold4w/scrubbers/hidden/layer2,
/obj/effect/mapping_helpers/airlock/access/all/security/brig,
/obj/machinery/door/airlock/security/glass{
	name = "Security Medbay"
	},
/turf/open/floor/plating,
/area/station/security/medical)
"Ye" = (
/obj/machinery/atmospherics/pipe/smart/manifold4w/supply/hidden/layer4,
/obj/machinery/atmospherics/pipe/smart/manifold4w/scrubbers/hidden/layer2,
/obj/effect/turf_decal/shuttle/exploration/hazardstripe{
	dir = 1
	},
/turf/open/floor/iron/dark/textured,
/area/station/security/medical)
"Yl" = (
/obj/structure/cable,
/obj/machinery/atmospherics/pipe/smart/manifold4w/supply/hidden/layer4,
/obj/machinery/atmospherics/pipe/smart/manifold4w/scrubbers/hidden/layer2,
/obj/structure/railing/corner/end{
	dir = 4
	},
/obj/effect/turf_decal/tile/red/real_red/anticorner{
	dir = 1
	},
/turf/open/floor/iron/dark/textured,
/area/station/security/medical)

(1,1,1) = {"
hj
hj
uJ
Wf
uJ
uW
"}
(2,1,1) = {"
hj
hj
hZ
Yl
bW
uW
"}
(3,1,1) = {"
hj
hj
hZ
vT
aL
uW
"}
(4,1,1) = {"
dh
dh
hZ
PJ
wN
uW
"}
(5,1,1) = {"
dh
Bw
Em
Fl
tc
uW
"}
(6,1,1) = {"
dh
qN
Ye
Nf
Vo
uW
"}
(7,1,1) = {"
uG
uG
uJ
pH
Nq
uW
"}
(8,1,1) = {"
hj
hj
uJ
uJ
uJ
uW
"}
