//MAP CONVERTED BY dmm2tgm.py THIS HEADER COMMENT PREVENTS RECONVERSION, DO NOT REMOVE
"bb" = (
/obj/machinery/atmospherics/pipe/smart/manifold4w/supply/hidden/layer4,
/obj/machinery/wall_healer/directional/east,
/obj/effect/turf_decal/tile/red/half{
	dir = 4
	},
/obj/structure/chair/office{
	dir = 1
	},
/obj/effect/landmark/start/security_medic,
/turf/open/floor/iron/white/textured,
/area/station/security/medical)
"bW" = (
/obj/item/storage/box/bodybags,
/obj/item/reagent_containers/syringe{
	name = "steel point"
	},
/obj/item/reagent_containers/cup/bottle/multiver,
/obj/item/reagent_containers/cup/bottle/epinephrine,
/obj/structure/table/glass,
/obj/structure/window/reinforced/spawner/directional/south,
/obj/structure/railing{
	dir = 1
	},
/obj/effect/turf_decal/tile/red/anticorner{
	dir = 8
	},
/obj/effect/turf_decal/tile/red/anticorner{
	dir = 8
	},
/turf/open/floor/iron/white/textured,
/area/station/security/execution/education)
"hZ" = (
/turf/closed/wall,
/area/station/security/medical)
"ik" = (
/obj/machinery/atmospherics/pipe/smart/manifold4w/scrubbers/hidden/layer2,
/obj/machinery/atmospherics/pipe/smart/manifold4w/supply/hidden/layer4,
/obj/structure/cable,
/obj/effect/landmark/event_spawn,
/obj/effect/turf_decal/tile/red/diagonal_centre,
/turf/open/floor/iron/dark/textured_half,
/area/station/security/medical)
"iE" = (
/turf/open/openspace,
/area/station/security/medical)
"kb" = (
/obj/machinery/atmospherics/pipe/smart/manifold4w/supply/hidden/layer4,
/turf/open/floor/iron/white/textured,
/area/station/security/medical)
"pH" = (
/obj/structure/window/reinforced/spawner/directional/south,
/obj/machinery/holopad,
/obj/structure/bed/medical/emergency,
/obj/structure/railing{
	dir = 1
	},
/obj/effect/turf_decal/tile/red/half,
/turf/open/floor/iron/white/textured,
/area/station/security/execution/education)
"qN" = (
/obj/machinery/door/firedoor/border_only,
/obj/machinery/door/window/brigdoor/left/directional/south{
	name = "Security Medpost"
	},
/obj/machinery/atmospherics/pipe/smart/manifold4w/supply/hidden/layer4,
/obj/machinery/atmospherics/pipe/smart/manifold4w/scrubbers/hidden/layer2,
/obj/structure/cable,
/obj/structure/railing/corner/end{
	dir = 8
	},
/turf/open/floor/iron/white/textured,
/area/station/security/execution/education)
"tc" = (
/obj/item/storage/medkit/regular{
	pixel_x = 3;
	pixel_y = 3
	},
/obj/structure/table/glass,
/obj/structure/window/reinforced/spawner/directional/south,
/obj/machinery/firealarm/directional/east,
/obj/item/storage/medkit/brute,
/obj/item/storage/medkit/fire,
/obj/item/storage/medkit/o2,
/obj/item/storage/medkit/toxin,
/obj/effect/turf_decal/tile/red/anticorner,
/obj/effect/turf_decal/tile/red/anticorner,
/turf/open/floor/iron/white/textured,
/area/station/security/execution/education)
"uJ" = (
/turf/closed/wall/r_wall,
/area/station/security/medical)
"uW" = (
/turf/closed/wall/r_wall,
/area/station/security/execution/education)
"Am" = (
/obj/machinery/airalarm/directional/north,
/obj/machinery/atmospherics/components/unary/vent_pump/on/layer4,
/obj/effect/turf_decal/tile/red/anticorner{
	dir = 4
	},
/obj/effect/turf_decal/tile/red/anticorner{
	dir = 4
	},
/obj/structure/table/glass,
/obj/machinery/computer/records/medical/laptop,
/turf/open/floor/iron/white/textured,
/area/station/security/medical)
"BW" = (
/obj/item/clothing/gloves/latex,
/obj/item/clothing/mask/surgical,
/obj/item/reagent_containers/spray/cleaner,
/obj/structure/table/glass,
/obj/structure/window/reinforced/spawner/directional/south,
/obj/effect/turf_decal/tile/red/half,
/turf/open/floor/iron/white/textured,
/area/station/security/execution/education)
"Eb" = (
/obj/machinery/camera/directional/west{
	c_tag = "Security - Infirmary"
	},
/obj/machinery/light_switch/directional/west,
/obj/machinery/atmospherics/components/unary/vent_scrubber/on/layer2{
	dir = 4
	},
/obj/structure/rack,
/obj/item/healthanalyzer,
/obj/item/storage/box/bandages{
	pixel_x = -6;
	pixel_y = 6
	},
/obj/item/storage/portable_chem_mixer,
/obj/item/reagent_containers/cup/tube,
/obj/item/reagent_containers/cup/tube,
/obj/structure/railing,
/obj/effect/turf_decal/tile/red/anticorner{
	dir = 1
	},
/obj/effect/turf_decal/tile/red/anticorner{
	dir = 1
	},
/turf/open/floor/iron/white/textured,
/area/station/security/medical)
"Li" = (
/obj/item/radio/intercom/directional/north,
/obj/effect/turf_decal/tile/red/half{
	dir = 1
	},
/obj/item/reagent_containers/blood,
/obj/machinery/iv_drip,
/turf/open/floor/iron/white/textured,
/area/station/security/medical)
"Lx" = (
/obj/machinery/light/cold/directional/north,
/obj/machinery/atmospherics/pipe/smart/manifold4w/scrubbers/hidden/layer2,
/obj/structure/cable,
/obj/structure/railing/corner/end/flip{
	dir = 8
	},
/obj/effect/turf_decal/tile/red/half{
	dir = 1
	},
/obj/machinery/biogenerator/medstation/directional/north,
/turf/open/floor/iron/white/textured,
/area/station/security/medical)
"RZ" = (
/obj/structure/cable,
/obj/machinery/atmospherics/pipe/smart/manifold4w/scrubbers/hidden/layer2,
/obj/structure/railing,
/obj/machinery/power/apc/auto_name/directional/north,
/obj/effect/turf_decal/tile/red/half{
	dir = 1
	},
/turf/open/floor/iron/white/textured,
/area/station/security/medical)
"Ye" = (
/turf/closed/wall,
/area/station/security/execution/education)

(1,1,1) = {"
uJ
hZ
hZ
Ye
"}
(2,1,1) = {"
uJ
Eb
iE
bW
"}
(3,1,1) = {"
uJ
RZ
iE
pH
"}
(4,1,1) = {"
uJ
Lx
ik
qN
"}
(5,1,1) = {"
uJ
Li
kb
BW
"}
(6,1,1) = {"
uJ
Am
bb
tc
"}
(7,1,1) = {"
uJ
uJ
uJ
uW
"}
