//MAP CONVERTED BY dmm2tgm.py THIS HEADER COMMENT PREVENTS RECONVERSION, DO NOT REMOVE
"a" = (
/obj/structure/cable,
/obj/machinery/atmospherics/pipe/smart/manifold4w/scrubbers/hidden/layer2,
/obj/machinery/light_switch/directional/east{
	pixel_y = 6;
	pixel_x = 24
	},
/obj/machinery/atmospherics/pipe/smart/manifold4w/supply/hidden/layer4,
/obj/effect/turf_decal/siding/wood{
	dir = 5
	},
/obj/machinery/button/door/directional/east{
	pixel_y = -6;
	name = "Privacy Shutters Control";
	id = "nt_rep_priv";
	req_access = list("cent_general")
	},
/turf/open/floor/wood/large,
/area/station/command/heads_quarters/nt_rep)
"b" = (
/obj/machinery/light/directional/east,
/obj/structure/sign/calendar/directional/east,
/turf/open/floor/carpet/executive,
/area/station/command/heads_quarters/nt_rep)
"c" = (
/obj/effect/turf_decal/siding/wood,
/turf/open/floor/wood/large,
/area/station/command/heads_quarters/nt_rep)
"d" = (
/obj/effect/turf_decal/siding/wood/corner{
	dir = 4
	},
/obj/effect/landmark/start/nanotrasen_crew_trainer,
/obj/machinery/atmospherics/pipe/smart/manifold4w/supply/hidden/layer4,
/turf/open/floor/wood/large,
/area/station/command/heads_quarters/nt_rep)
"e" = (
/obj/machinery/status_display/evac/directional/east,
/obj/structure/safe/floor,
/obj/item/clothing/accessory/medal/gold/nanotrasen_consultant,
/obj/item/clothing/accessory/medal/silver/bureaucracy,
/obj/item/clothing/accessory/medal/gold/ordom,
/turf/open/floor/carpet/executive,
/area/station/command/heads_quarters/nt_rep)
"f" = (
/obj/structure/table/reinforced/titaniumglass,
/obj/machinery/fax{
	fax_name = "Nanotrasen Consultant's Office";
	name = "Nanotrasen Consultant's Fax Machine"
	},
/turf/open/floor/carpet/executive,
/area/station/command/heads_quarters/nt_rep)
"g" = (
/obj/machinery/modular_computer/preset/time_clock/directional/south,
/obj/effect/turf_decal/tile/blue{
	dir = 8
	},
/turf/open/floor/iron,
/area/station/hallway/primary/port)
"h" = (
/obj/effect/mapping_helpers/airlock/access/all/cent_com/rep_door,
/obj/machinery/door/airlock/maintenance,
/turf/open/floor/iron/dark/smooth_large,
/area/station/command/heads_quarters/nt_rep)
"j" = (
/obj/structure/table/reinforced/titaniumglass,
/obj/item/paper_bin{
	pixel_y = 5;
	pixel_x = -4
	},
/obj/item/stamp{
	pixel_y = 12;
	pixel_x = 8
	},
/obj/item/stamp/denied{
	pixel_x = 8;
	pixel_y = 6
	},
/obj/item/stamp/nanotrasen{
	pixel_x = 8
	},
/obj/item/pen/fountain/nanotrasen{
	pixel_y = 5;
	pixel_x = -4
	},
/turf/open/floor/carpet/executive,
/area/station/command/heads_quarters/nt_rep)
"k" = (
/obj/effect/turf_decal/siding/wood{
	dir = 1
	},
/obj/machinery/atmospherics/components/unary/vent_pump/on/layer4{
	dir = 8
	},
/turf/open/floor/wood/large,
/area/station/command/heads_quarters/nt_rep)
"l" = (
/obj/structure/table/reinforced/titaniumglass,
/obj/machinery/recharger{
	pixel_y = 3;
	pixel_x = 7
	},
/obj/item/flashlight/lamp/green{
	pixel_y = 13;
	pixel_x = -6
	},
/obj/item/phone{
	pixel_x = -4;
	pixel_y = -1
	},
/obj/item/reagent_containers/cup/glass/mug/nanotrasen{
	pixel_x = 9;
	pixel_y = 17
	},
/turf/open/floor/carpet/executive,
/area/station/command/heads_quarters/nt_rep)
"n" = (
/obj/effect/turf_decal/siding/wood{
	dir = 6
	},
/obj/structure/hedge,
/turf/open/floor/wood/large,
/area/station/command/heads_quarters/nt_rep)
"o" = (
/obj/effect/turf_decal/siding/wood,
/obj/structure/filingcabinet/medical{
	pixel_x = -10;
	icon_state = "employmentcabinet";
	name = "medical records filing cabinet"
	},
/obj/structure/filingcabinet/security{
	pixel_x = 10;
	icon_state = "employmentcabinet";
	name = "security records filing cabinet"
	},
/obj/structure/sign/clock/directional/south,
/obj/structure/filingcabinet/employment{
	name = "employment forms filing cabinet"
	},
/turf/open/floor/wood/large,
/area/station/command/heads_quarters/nt_rep)
"p" = (
/obj/structure/cable,
/turf/open/floor/wood/large,
/area/station/command/heads_quarters/nt_rep)
"r" = (
/obj/structure/table/wood,
/obj/item/table_clock{
	pixel_y = 5
	},
/obj/effect/turf_decal/siding/wood{
	dir = 9
	},
/obj/item/radio/intercom/directional/west,
/turf/open/floor/wood/large,
/area/station/command/heads_quarters/nt_rep)
"s" = (
/obj/effect/turf_decal/tile/blue{
	dir = 8
	},
/turf/open/floor/iron,
/area/station/hallway/primary/port)
"t" = (
/obj/machinery/modular_computer/preset/command,
/obj/machinery/requests_console/directional/north{
	department = "Nanotrasen Consultant's Desk";
	name = "Nanotrasen Consultant's Requests Console"
	},
/obj/effect/mapping_helpers/requests_console/announcement,
/obj/effect/mapping_helpers/requests_console/assistance,
/obj/effect/mapping_helpers/requests_console/information,
/turf/open/floor/carpet/executive,
/area/station/command/heads_quarters/nt_rep)
"u" = (
/obj/structure/bed/dogbed/ian{
	name = "Lisa's bed";
	desc = "Lisa's bed! Looks comfy."
	},
/mob/living/basic/pet/dog/corgi/lisa,
/obj/effect/turf_decal/siding/wood,
/obj/machinery/newscaster/directional/south,
/turf/open/floor/wood/large,
/area/station/command/heads_quarters/nt_rep)
"v" = (
/obj/effect/turf_decal/siding/wood{
	dir = 1
	},
/obj/machinery/modular_computer/preset/civilian,
/turf/open/floor/wood/large,
/area/station/command/heads_quarters/nt_rep)
"w" = (
/turf/closed/wall,
/area/station/command/heads_quarters/nt_rep)
"x" = (
/obj/structure/cable,
/obj/machinery/atmospherics/pipe/smart/manifold4w/supply/hidden/layer4,
/obj/effect/turf_decal/siding/wood{
	dir = 4
	},
/obj/structure/chair/wood{
	dir = 4
	},
/turf/open/floor/wood/large,
/area/station/command/heads_quarters/nt_rep)
"z" = (
/obj/effect/turf_decal/siding/wood{
	dir = 1
	},
/obj/machinery/atmospherics/pipe/smart/manifold4w/supply/hidden/layer4,
/turf/open/floor/wood/large,
/area/station/command/heads_quarters/nt_rep)
"B" = (
/obj/effect/turf_decal/siding/wood{
	dir = 4
	},
/obj/machinery/atmospherics/pipe/smart/manifold4w/supply/hidden/layer4,
/obj/machinery/holopad,
/turf/open/floor/wood/large,
/area/station/command/heads_quarters/nt_rep)
"C" = (
/obj/structure/noticeboard/directional/north{
	name = "Nanotrasen Consultant's Notice Board"
	},
/obj/machinery/keycard_auth/wall_mounted/directional/east,
/obj/structure/closet/secure_closet/nanotrasen_consultant,
/turf/open/floor/carpet/executive,
/area/station/command/heads_quarters/nt_rep)
"E" = (
/obj/structure/table/reinforced/titaniumglass,
/obj/item/clipboard{
	pixel_y = 4;
	pixel_x = -3
	},
/obj/item/folder/blue{
	pixel_y = 1
	},
/obj/item/sign/flag/nanotrasen{
	pixel_x = 5
	},
/turf/open/floor/carpet/executive,
/area/station/command/heads_quarters/nt_rep)
"F" = (
/obj/structure/chair/office{
	dir = 8
	},
/obj/effect/landmark/start/nanotrasen_crew_trainer,
/obj/machinery/atmospherics/components/unary/vent_scrubber/on/layer2{
	dir = 4
	},
/turf/open/floor/wood/large,
/area/station/command/heads_quarters/nt_rep)
"G" = (
/obj/structure/cable,
/obj/machinery/atmospherics/pipe/smart/manifold4w/scrubbers/hidden/layer2,
/obj/machinery/atmospherics/pipe/smart/manifold4w/supply/hidden/layer4,
/obj/effect/turf_decal/siding/wood{
	dir = 4
	},
/turf/open/floor/wood/large,
/area/station/command/heads_quarters/nt_rep)
"H" = (
/turf/open/floor/wood/large,
/area/station/command/heads_quarters/nt_rep)
"I" = (
/obj/machinery/firealarm/directional/west,
/obj/effect/turf_decal/siding/wood{
	dir = 8
	},
/obj/structure/table/wood,
/obj/item/clipboard{
	pixel_y = 3;
	pixel_x = 2
	},
/obj/item/folder/yellow{
	pixel_y = 1;
	pixel_x = -2
	},
/turf/open/floor/wood/large,
/area/station/command/heads_quarters/nt_rep)
"J" = (
/obj/effect/turf_decal/tile/blue{
	dir = 8
	},
/obj/structure/sign/flag/nanotrasen/directional/south,
/turf/open/floor/iron,
/area/station/hallway/primary/port)
"M" = (
/obj/structure/cable,
/obj/machinery/atmospherics/pipe/smart/manifold4w/scrubbers/hidden/layer2,
/obj/effect/mapping_helpers/airlock/access/all/cent_com/rep_door,
/obj/machinery/door/firedoor,
/obj/effect/landmark/navigate_destination/autoname,
/obj/effect/mapping_helpers/airlock/unres,
/obj/machinery/atmospherics/pipe/smart/manifold4w/supply/hidden/layer4,
/obj/machinery/door/airlock/corporate{
	name = "Nanotrasen Internal Affairs Office"
	},
/turf/open/floor/iron/dark/smooth_large,
/area/station/command/heads_quarters/nt_rep)
"O" = (
/obj/structure/chair/comfy/brown{
	dir = 8
	},
/obj/effect/landmark/start/nanotrasen_consultant,
/turf/open/floor/carpet/executive,
/area/station/command/heads_quarters/nt_rep)
"Q" = (
/obj/machinery/airalarm/directional/west,
/obj/effect/turf_decal/siding/wood{
	dir = 8
	},
/obj/structure/closet/secure_closet/nanotrasen_crew_trainer,
/obj/item/storage/lunchbox/nanotrasen,
/turf/open/floor/wood/large,
/area/station/command/heads_quarters/nt_rep)
"R" = (
/obj/effect/spawner/structure/window/reinforced,
/obj/machinery/door/poddoor/shutters/preopen{
	id = "nt_rep_priv";
	name = "Privacy Shutters";
	dir = 1
	},
/obj/structure/cable,
/turf/open/floor/plating,
/area/station/command/heads_quarters/nt_rep)
"S" = (
/turf/closed/wall/r_wall,
/area/station/command/heads_quarters/nt_rep)
"T" = (
/turf/template_noop,
/area/template_noop)
"U" = (
/obj/structure/cable,
/obj/machinery/power/apc/auto_name/directional/west,
/obj/machinery/camera/autoname/directional/west,
/obj/machinery/light/directional/west,
/obj/effect/turf_decal/siding/wood{
	dir = 8
	},
/obj/structure/table/wood,
/obj/item/paper_bin{
	pixel_y = 5;
	pixel_x = -4
	},
/obj/item/pen{
	pixel_y = 5;
	pixel_x = -4
	},
/obj/item/stamp{
	pixel_y = 9;
	pixel_x = 8
	},
/obj/item/stamp/denied{
	pixel_x = 8;
	pixel_y = 2
	},
/turf/open/floor/wood/large,
/area/station/command/heads_quarters/nt_rep)
"V" = (
/obj/machinery/photocopier/prebuilt,
/obj/effect/turf_decal/siding/wood,
/obj/structure/sign/poster/official/nanotrasen_logo/directional/south,
/obj/item/toy/plush/skyrat/ian/lisa{
	pixel_y = 11
	},
/turf/open/floor/wood/large,
/area/station/command/heads_quarters/nt_rep)
"X" = (
/obj/effect/turf_decal/siding/wood{
	dir = 10
	},
/obj/structure/hedge,
/turf/open/floor/wood/large,
/area/station/command/heads_quarters/nt_rep)
"Y" = (
/obj/effect/turf_decal/siding/wood{
	dir = 5
	},
/obj/structure/sign/poster/official/enlist/directional/east,
/turf/open/floor/wood/large,
/area/station/command/heads_quarters/nt_rep)
"Z" = (
/obj/effect/turf_decal/siding/wood{
	dir = 8
	},
/obj/structure/extinguisher_cabinet/directional/west,
/obj/structure/aquarium/prefilled,
/obj/item/reagent_containers/cup/fish_feed{
	pixel_y = 17;
	pixel_x = -3
	},
/turf/open/floor/wood/large,
/area/station/command/heads_quarters/nt_rep)

(1,1,1) = {"
J
S
S
S
S
S
S
S
S
"}
(2,1,1) = {"
s
R
r
I
U
Q
Z
X
S
"}
(3,1,1) = {"
s
R
v
F
p
H
H
o
S
"}
(4,1,1) = {"
s
M
a
G
x
B
d
u
S
"}
(5,1,1) = {"
g
S
S
f
E
l
z
c
h
"}
(6,1,1) = {"
T
T
S
t
O
j
k
V
S
"}
(7,1,1) = {"
T
T
S
C
e
b
Y
n
S
"}
(8,1,1) = {"
T
w
S
S
S
S
S
S
S
"}
