"a" = (/obj/machinery/camera/directional/south{c_tag = "Brig - Infirmary"},/obj/structure/disposalpipe/segment{dir = 4},/obj/structure/cable,/obj/effect/turf_decal/trimline/blue/filled/line{dir = 6},/obj/machinery/atmospherics/components/unary/vent_scrubber/on/layer2{dir = 4},/obj/machinery/atmospherics/pipe/smart/manifold4w/cyan/hidden,/obj/structure/window/reinforced/spawner/directional/east,/obj/structure/table/reinforced/rglass,/obj/item/reagent_containers/spray/cleaner{pixel_x = 6; pixel_y = 16},/obj/item/reagent_containers/cup/bottle/epinephrine{pixel_x = -7; pixel_y = 14},/obj/item/reagent_containers/cup/bottle/multiver{pixel_x = -2; pixel_y = 14},/obj/item/reagent_containers/syringe{pixel_x = -4; pixel_y = -4},/obj/item/storage/box/bandages{pixel_x = -7; pixel_y = 5},/obj/item/storage/medkit/regular{pixel_x = 0; pixel_y = 4},/turf/open/floor/iron/white,/area/station/security/medical)
"c" = (/obj/effect/turf_decal/trimline/blue/filled/line{dir = 6},/turf/open/floor/iron/white,/area/station/security/medical)
"f" = (/obj/structure/disposalpipe/segment{dir = 4},/obj/structure/cable,/obj/effect/turf_decal/trimline/blue/filled/line,/obj/machinery/atmospherics/pipe/smart/manifold4w/supply/hidden/layer4,/obj/machinery/power/apc/auto_name/directional/south,/obj/machinery/atmospherics/pipe/smart/manifold4w/cyan/hidden,/obj/structure/sink/directional/north,/obj/effect/turf_decal/trimline/blue/filled/corner{dir = 4},/turf/open/floor/iron/white,/area/station/security/medical)
"g" = (/obj/effect/turf_decal/trimline/blue/filled/line{dir = 4},/obj/machinery/atmospherics/pipe/smart/manifold4w/supply/hidden/layer4,/obj/structure/window/reinforced/spawner/directional/east,/obj/machinery/computer/records/medical/laptop{dir = 8; pixel_y = 3; pixel_x = -4},/obj/structure/table/reinforced,/obj/effect/turf_decal/trimline/blue/filled/corner{dir = 8},/turf/open/floor/iron/white,/area/station/security/medical)
"i" = (/obj/effect/turf_decal/trimline/blue/filled/line{dir = 8},/obj/machinery/computer/operating{dir = 4},/obj/machinery/light/directional/west,/obj/structure/extinguisher_cabinet/directional/west,/obj/effect/turf_decal/trimline/blue/filled/corner{dir = 4},/turf/open/floor/iron/white,/area/station/security/medical)
"j" = (/obj/structure/disposalpipe/segment{dir = 4},/obj/structure/cable,/obj/effect/turf_decal/trimline/blue/filled/line{dir = 10},/obj/machinery/atmospherics/pipe/smart/manifold4w/supply/hidden/layer4,/obj/machinery/atmospherics/pipe/smart/manifold4w/cyan/hidden,/turf/open/floor/iron/white,/area/station/security/medical)
"o" = (/obj/effect/turf_decal/trimline/blue/filled/line{dir = 1},/obj/machinery/computer/crew,/obj/structure/table/reinforced,/obj/machinery/atmospherics/components/unary/vent_pump/on/layer4,/obj/effect/turf_decal/trimline/blue/filled/corner{dir = 8},/obj/machinery/airalarm/directional/north,/turf/open/floor/iron/white,/area/station/security/medical)
"r" = (/obj/machinery/atmospherics/pipe/smart/manifold4w/supply/hidden/layer4,/obj/structure/chair/office/light{dir = 4},/obj/effect/turf_decal/trimline/blue/filled/line{dir = 10},/turf/open/floor/iron/white,/area/station/security/medical)
"t" = (/turf/closed/wall/r_wall,/area/station/security/medical)
"w" = (/turf/closed/wall/r_wall,/area/station/security/prison/visit)
"y" = (/obj/effect/turf_decal/trimline/blue/filled/line{dir = 5},/obj/structure/window/reinforced/spawner/directional/east,/obj/structure/table/reinforced,/obj/item/paper_bin{pixel_x = 2; pixel_y = 5},/obj/item/pen{pixel_x = 3; pixel_y = 6},/obj/item/folder/red{pixel_x = -2; pixel_y = -12},/obj/item/reagent_containers/cup/glass/mug/nanotrasen{pixel_x = -12; pixel_y = 7},/obj/item/folder/white{pixel_x = 2; pixel_y = -12},/obj/item/healthanalyzer{pixel_x = -8; pixel_y = -4},/turf/open/floor/iron/white,/area/station/security/medical)
"A" = (/turf/closed/wall/r_wall,/area/station/maintenance/port/fore)
"B" = (/obj/effect/turf_decal/trimline/blue/filled/line{dir = 8},/obj/structure/table/optable,/obj/machinery/defibrillator_mount/directional/west,/obj/effect/turf_decal/trimline/blue/filled/corner,/turf/open/floor/iron/white,/area/station/security/medical)
"D" = (/turf/closed/wall,/area/station/security/medical)
"F" = (/obj/structure/disposalpipe/segment{dir = 4},/obj/structure/cable,/obj/effect/turf_decal/trimline/blue/filled/line,/obj/machinery/atmospherics/pipe/smart/manifold4w/supply/hidden/layer4,/obj/effect/turf_decal/tile/red{dir = 8},/obj/machinery/atmospherics/pipe/smart/manifold4w/cyan/hidden,/obj/machinery/stasis,/obj/item/bedsheet,/obj/machinery/iv_drip,/obj/effect/turf_decal/trimline/blue/filled/corner{dir = 1},/obj/machinery/wall_healer/directional/south,/turf/open/floor/iron/white,/area/station/security/medical)
"H" = (/obj/effect/turf_decal/trimline/blue/filled/line{dir = 9},/obj/structure/table/reinforced/rglass,/obj/effect/spawner/surgery_tray/full,/obj/machinery/status_display/evac/directional/west,/turf/open/floor/iron/white,/area/station/security/medical)
"J" = (/obj/machinery/atmospherics/pipe/smart/manifold4w/supply/hidden/layer4,/obj/effect/turf_decal/trimline/blue/filled/line{dir = 9},/turf/open/floor/iron/white,/area/station/security/medical)
"L" = (/obj/item/radio/intercom/directional/north,/obj/effect/turf_decal/trimline/blue/filled/line{dir = 1},/obj/structure/closet/secure_closet/security_medic,/obj/effect/turf_decal/trimline/blue/filled/corner,/turf/open/floor/iron/white,/area/station/security/medical)
"P" = (/obj/structure/disposalpipe/segment{dir = 4},/obj/machinery/door/airlock/maintenance{name = "Brig Infirmary Maintenance"},/obj/structure/cable,/obj/machinery/atmospherics/pipe/smart/manifold4w/supply/hidden/layer4,/obj/effect/mapping_helpers/airlock/access/all/security/general,/obj/machinery/atmospherics/pipe/smart/manifold4w/cyan/hidden,/turf/open/floor/plating,/area/station/maintenance/port/fore)
"R" = (/obj/effect/landmark/event_spawn,/obj/effect/turf_decal/trimline/blue/filled/line{dir = 5},/turf/open/floor/iron/white,/area/station/security/medical)
"W" = (/obj/machinery/door/window/right/directional/east{name = "Infirmary"},/obj/effect/turf_decal/trimline/blue/filled/warning{dir = 4},/obj/effect/turf_decal/trimline/blue/filled/corner{dir = 1},/turf/open/floor/iron/white,/area/station/security/medical)

(1,1,1) = {"
wtDDD
AHLoy
ABcrg
AiRJW
PjfFa
AttDD
"}
