//MAP CONVERTED BY dmm2tgm.py THIS HEADER COMMENT PREVENTS RECONVERSION, DO NOT REMOVE
"aq" = (
/obj/machinery/button/flasher{
	id = "visitorflash";
	pixel_x = -6;
	pixel_y = 24;
	dir = 1
	},
/obj/machinery/button/door/directional/north{
	id = "visitation";
	name = "Visitation Shutters";
	pixel_x = 6;
	req_access = list("brig")
	},
/obj/structure/cable,
/obj/machinery/atmospherics/pipe/smart/manifold4w/supply/hidden/layer4,
/obj/machinery/atmospherics/pipe/smart/manifold4w/scrubbers/hidden/layer2,
/turf/open/floor/iron,
/area/station/security/brig)
"at" = (
/obj/machinery/atmospherics/components/unary/vent_pump/on/layer4{
	dir = 4
	},
/turf/open/floor/iron/white,
/area/station/security/medical)
"bb" = (
/obj/structure/disposalpipe/segment{
	dir = 4
	},
/obj/machinery/door/airlock/maintenance{
	name = "Brig Infirmary Maintenance"
	},
/obj/structure/cable,
/obj/machinery/atmospherics/pipe/smart/manifold4w/supply/hidden/layer4,
/obj/effect/mapping_helpers/airlock/access/all/security/general,
/obj/machinery/atmospherics/pipe/smart/manifold4w/cyan/hidden,
/turf/open/floor/plating,
/area/station/maintenance/port/fore)
"bW" = (
/obj/effect/landmark/event_spawn,
/turf/open/floor/iron/white,
/area/station/security/medical)
"dh" = (
/obj/structure/window/reinforced/spawner/directional/south,
/obj/machinery/atmospherics/components/unary/vent_pump/on/layer4{
	dir = 1
	},
/turf/open/floor/iron,
/area/station/security/brig)
"hj" = (
/turf/template_noop,
/area/template_noop)
"ho" = (
/obj/effect/turf_decal/trimline/red/filled/line{
	dir = 8
	},
/obj/structure/cable,
/obj/machinery/atmospherics/pipe/smart/manifold4w/scrubbers/hidden/layer2,
/obj/machinery/atmospherics/pipe/smart/manifold4w/supply/hidden/layer4,
/turf/open/floor/iron,
/area/station/security/brig)
"hZ" = (
/obj/effect/turf_decal/trimline/blue/filled/line{
	dir = 5
	},
/obj/structure/window/spawner/directional/east,
/obj/effect/turf_decal/trimline/dark_red/line{
	dir = 5
	},
/turf/open/floor/iron/white,
/area/station/security/medical)
"ik" = (
/obj/structure/disposalpipe/segment{
	dir = 4
	},
/obj/structure/cable,
/obj/effect/turf_decal/trimline/blue/filled/line{
	dir = 10
	},
/obj/machinery/atmospherics/pipe/smart/manifold4w/supply/hidden/layer4,
/obj/machinery/atmospherics/pipe/smart/manifold4w/cyan/hidden,
/obj/structure/sign/poster/official/nanotrasen_logo/directional/south,
/obj/effect/turf_decal/trimline/dark_red/line{
	dir = 10
	},
/turf/open/floor/iron/white,
/area/station/security/medical)
"iE" = (
/obj/structure/cable,
/obj/machinery/atmospherics/pipe/smart/manifold4w/scrubbers/hidden/layer2,
/obj/machinery/atmospherics/pipe/smart/manifold4w/supply/hidden/layer4,
/turf/open/floor/iron,
/area/station/security/brig)
"kb" = (
/obj/structure/chair/stool/directional/west,
/obj/machinery/camera/directional/north{
	c_tag = "Prison Visitation";
	network = list("ss13","prison")
	},
/obj/effect/turf_decal/trimline/red/warning{
	dir = 8
	},
/obj/structure/cable,
/obj/machinery/firealarm/directional/north,
/obj/machinery/atmospherics/pipe/smart/manifold4w/supply/hidden/layer4,
/turf/open/floor/iron,
/area/station/security/brig)
"mF" = (
/obj/effect/turf_decal/trimline/blue/filled/line{
	dir = 8
	},
/obj/structure/bed/medical/emergency,
/obj/effect/turf_decal/trimline/dark_red/line{
	dir = 8
	},
/turf/open/floor/iron/white,
/area/station/security/medical)
"pH" = (
/obj/structure/window/spawner/directional/east,
/obj/structure/table,
/obj/item/paper_bin{
	pixel_x = -3;
	pixel_y = 7
	},
/obj/item/pen,
/obj/machinery/light/small/directional/north,
/obj/effect/turf_decal/trimline/dark_red/filled/line{
	dir = 5
	},
/obj/effect/turf_decal/trimline/dark_blue/filled/corner{
	dir = 8
	},
/turf/open/floor/iron/white,
/area/station/security/medical)
"qy" = (
/obj/structure/window/reinforced/spawner/directional/south,
/obj/machinery/atmospherics/components/unary/vent_scrubber/on/layer2{
	dir = 1
	},
/turf/open/floor/iron,
/area/station/security/brig)
"qN" = (
/obj/effect/turf_decal/trimline/dark_red/filled/line,
/obj/structure/chair/office{
	dir = 1
	},
/obj/effect/turf_decal/trimline/dark_blue/filled/line{
	dir = 1
	},
/turf/open/floor/iron/white,
/area/station/security/medical)
"tc" = (
/turf/closed/wall/r_wall,
/area/station/security/medical)
"uG" = (
/obj/structure/window/spawner/directional/east,
/obj/effect/turf_decal/trimline/dark_red/filled/line{
	dir = 6
	},
/obj/effect/turf_decal/trimline/dark_blue/filled/corner{
	dir = 1
	},
/turf/open/floor/iron/white,
/area/station/security/medical)
"uJ" = (
/obj/effect/turf_decal/trimline/dark_red/filled/line{
	dir = 8
	},
/turf/open/floor/iron,
/area/station/security/brig)
"uW" = (
/turf/closed/wall/r_wall,
/area/station/security/brig)
"vT" = (
/obj/structure/rack,
/obj/machinery/camera/directional/south{
	c_tag = "Brig - Infirmary"
	},
/obj/item/clothing/under/rank/medical/scrubs/purple,
/obj/item/healthanalyzer{
	pixel_y = -2
	},
/obj/structure/disposalpipe/segment{
	dir = 4
	},
/obj/structure/cable,
/obj/effect/turf_decal/trimline/blue/filled/line{
	dir = 6
	},
/obj/machinery/atmospherics/components/unary/vent_scrubber/on/layer2{
	dir = 4
	},
/obj/structure/window/spawner/directional/east,
/obj/machinery/atmospherics/pipe/smart/manifold4w/cyan/hidden,
/obj/item/reagent_containers/cup/tube,
/obj/item/reagent_containers/cup/tube,
/obj/item/storage/portable_chem_mixer,
/obj/item/wallframe/frontier_medstation,
/obj/effect/turf_decal/trimline/dark_red/line{
	dir = 6
	},
/turf/open/floor/iron/white,
/area/station/security/medical)
"yb" = (
/obj/effect/turf_decal/trimline/red/filled/corner{
	dir = 1
	},
/obj/effect/turf_decal/trimline/dark_red/filled/corner{
	dir = 8
	},
/turf/open/floor/iron,
/area/station/security/brig)
"zm" = (
/obj/structure/table,
/obj/item/reagent_containers/cup/bottle/epinephrine,
/obj/item/reagent_containers/cup/bottle/multiver,
/obj/item/storage/medkit/regular,
/obj/item/storage/box/bandages{
	pixel_x = -6;
	pixel_y = 6
	},
/obj/item/reagent_containers/syringe,
/obj/effect/turf_decal/trimline/dark_red/filled/line{
	dir = 10
	},
/obj/effect/turf_decal/trimline/dark_blue/filled/corner{
	dir = 4
	},
/turf/open/floor/iron/white,
/area/station/security/medical)
"Be" = (
/obj/item/radio/intercom/directional/north,
/obj/structure/table,
/obj/item/reagent_containers/spray/cleaner,
/obj/item/clothing/gloves/latex,
/obj/item/clothing/mask/surgical,
/obj/effect/turf_decal/trimline/dark_red/filled/line{
	dir = 9
	},
/obj/structure/sign/poster/official/moth_epi/directional/west,
/obj/effect/turf_decal/trimline/dark_blue/filled/corner,
/obj/item/healthanalyzer,
/turf/open/floor/iron/white,
/area/station/security/medical)
"Bw" = (
/obj/machinery/door/airlock/security/glass{
	name = "Permabrig Visitation"
	},
/obj/machinery/atmospherics/pipe/smart/manifold4w/supply/hidden/layer4,
/obj/machinery/atmospherics/pipe/smart/manifold4w/scrubbers/hidden/layer2,
/obj/machinery/door/firedoor,
/obj/effect/mapping_helpers/airlock/access/all/security/brig,
/obj/structure/cable,
/turf/open/floor/iron,
/area/station/security/brig)
"BW" = (
/obj/structure/cable,
/obj/effect/spawner/structure/window/reinforced,
/turf/open/floor/plating,
/area/station/security/brig)
"Cn" = (
/obj/effect/turf_decal/trimline/dark_red/filled/line,
/obj/effect/turf_decal/trimline/dark_blue/filled/line{
	dir = 1
	},
/turf/open/floor/iron/white,
/area/station/security/medical)
"Du" = (
/obj/effect/turf_decal/trimline/blue/filled/line{
	dir = 4
	},
/obj/machinery/door/window/right/directional/east{
	name = "Infirmary"
	},
/obj/effect/turf_decal/trimline/dark_red/line{
	dir = 4
	},
/turf/open/floor/iron/white,
/area/station/security/medical)
"Em" = (
/obj/effect/turf_decal/trimline/blue/filled/line{
	dir = 9
	},
/obj/machinery/wall_healer/directional/west,
/obj/structure/table/optable,
/obj/item/wallframe/defib_mount,
/obj/machinery/light/small/directional/west,
/obj/effect/turf_decal/trimline/dark_red/line{
	dir = 9
	},
/obj/item/storage/medkit/surgery{
	pixel_x = -2;
	pixel_y = 0
	},
/turf/open/floor/iron/white,
/area/station/security/medical)
"Fl" = (
/obj/structure/disposalpipe/segment{
	dir = 4
	},
/obj/structure/cable,
/obj/effect/turf_decal/trimline/blue/filled/line,
/obj/machinery/atmospherics/pipe/smart/manifold4w/supply/hidden/layer4,
/obj/machinery/power/apc/auto_name/directional/south,
/obj/machinery/atmospherics/pipe/smart/manifold4w/cyan/hidden,
/obj/effect/turf_decal/trimline/dark_red/line,
/turf/open/floor/iron/white,
/area/station/security/medical)
"Ge" = (
/obj/structure/cable,
/turf/open/floor/iron,
/area/station/security/brig)
"IJ" = (
/turf/closed/wall,
/area/station/security/brig)
"OC" = (
/obj/machinery/door/poddoor/shutters{
	dir = 4;
	id = "visitation";
	name = "Visitation Shutters"
	},
/obj/machinery/door/window/left/directional/east,
/obj/structure/table,
/obj/structure/cable,
/turf/open/floor/iron,
/area/station/security/prison/visit)
"Pt" = (
/obj/machinery/door/window/left/directional/east{
	name = "Infirmary"
	},
/obj/effect/turf_decal/trimline/blue/filled/line{
	dir = 4
	},
/obj/machinery/atmospherics/pipe/smart/manifold4w/supply/hidden/layer4,
/obj/effect/turf_decal/trimline/dark_red/line{
	dir = 4
	},
/turf/open/floor/iron/white,
/area/station/security/medical)
"PJ" = (
/turf/closed/wall,
/area/station/security/medical)
"Ra" = (
/obj/structure/extinguisher_cabinet/directional/west,
/obj/effect/turf_decal/trimline/blue/filled/line{
	dir = 8
	},
/obj/machinery/computer/operating{
	dir = 4
	},
/obj/effect/turf_decal/trimline/dark_red/line{
	dir = 8
	},
/turf/open/floor/iron/white,
/area/station/security/medical)
"Ri" = (
/obj/structure/table,
/obj/machinery/computer/records/medical/laptop,
/obj/effect/turf_decal/trimline/dark_red/filled/line{
	dir = 1
	},
/obj/effect/turf_decal/trimline/dark_blue/filled/line,
/obj/item/folder/red{
	pixel_x = 3
	},
/obj/item/folder/white{
	pixel_x = -4;
	pixel_y = 2
	},
/turf/open/floor/iron/white,
/area/station/security/medical)
"RV" = (
/obj/effect/turf_decal/trimline/blue/filled/line{
	dir = 1
	},
/obj/effect/turf_decal/trimline/dark_red/line{
	dir = 1
	},
/turf/open/floor/iron/white,
/area/station/security/medical)
"RZ" = (
/turf/closed/wall/r_wall,
/area/station/security/prison/visit)
"Tf" = (
/obj/effect/turf_decal/trimline/blue/filled/line{
	dir = 1
	},
/obj/effect/turf_decal/trimline/dark_red/line{
	dir = 1
	},
/obj/effect/landmark/start/security_medic,
/turf/open/floor/iron/white,
/area/station/security/medical)
"Vo" = (
/obj/structure/table,
/obj/effect/turf_decal/trimline/dark_red/filled/line{
	dir = 1
	},
/obj/effect/turf_decal/trimline/dark_blue/filled/line,
/obj/item/storage/medkit/brute{
	pixel_x = -5;
	pixel_y = 0
	},
/obj/item/storage/medkit/fire{
	pixel_x = 5;
	pixel_y = 0
	},
/obj/item/storage/medkit/o2{
	pixel_x = 6;
	pixel_y = 5
	},
/obj/item/storage/medkit/toxin{
	pixel_x = -5;
	pixel_y = 5
	},
/turf/open/floor/iron/white,
/area/station/security/medical)
"Wf" = (
/turf/closed/wall/r_wall,
/area/station/maintenance/port/fore)
"Ye" = (
/obj/structure/bed/medical/anchored{
	dir = 4
	},
/obj/item/bedsheet,
/obj/structure/disposalpipe/segment{
	dir = 4
	},
/obj/machinery/iv_drip,
/obj/structure/cable,
/obj/effect/turf_decal/trimline/blue/filled/line,
/obj/machinery/atmospherics/pipe/smart/manifold4w/supply/hidden/layer4,
/obj/effect/turf_decal/tile/red{
	dir = 8
	},
/obj/machinery/light/small/directional/south,
/obj/machinery/atmospherics/pipe/smart/manifold4w/cyan/hidden,
/obj/machinery/airalarm/directional/south,
/obj/effect/turf_decal/trimline/dark_red/line,
/turf/open/floor/iron/white,
/area/station/security/medical)
"Yl" = (
/obj/structure/chair/stool/directional/east,
/obj/effect/turf_decal/trimline/red/warning{
	dir = 4
	},
/obj/machinery/flasher/directional/north{
	id = "visitorflash"
	},
/obj/structure/cable,
/turf/open/floor/iron,
/area/station/security/prison/visit)
"YF" = (
/obj/effect/turf_decal/trimline/red/filled/line{
	dir = 4
	},
/obj/machinery/atmospherics/components/unary/vent_scrubber/on/layer2{
	dir = 1
	},
/obj/structure/cable,
/turf/open/floor/iron/white,
/area/station/security/prison/visit)
"ZJ" = (
/obj/machinery/atmospherics/pipe/smart/manifold4w/supply/hidden/layer4,
/turf/open/floor/iron/white,
/area/station/security/medical)

(1,1,1) = {"
hj
YF
hj
hj
hj
hj
hj
hj
hj
hj
"}
(2,1,1) = {"
uW
Yl
RZ
RZ
RZ
Wf
Wf
Wf
bb
Wf
"}
(3,1,1) = {"
uW
OC
RZ
Be
zm
Em
Ra
mF
ik
tc
"}
(4,1,1) = {"
IJ
kb
dh
Vo
Cn
Tf
at
bW
Fl
tc
"}
(5,1,1) = {"
IJ
aq
qy
Ri
qN
RV
ZJ
ZJ
Ye
PJ
"}
(6,1,1) = {"
IJ
Bw
BW
pH
uG
hZ
Pt
Du
vT
PJ
"}
(7,1,1) = {"
hj
ho
yb
uJ
uJ
hj
hj
hj
hj
hj
"}
(8,1,1) = {"
hj
iE
hj
hj
Ge
hj
hj
hj
hj
hj
"}
