//MAP CONVERTED BY dmm2tgm.py THIS HEADER COMMENT PREVENTS RECONVERSION, DO NOT REMOVE
"aA" = (
/obj/machinery/vending/assist,
/turf/open/floor/iron,
/area/station/hallway/primary/starboard)
"bT" = (
/obj/machinery/firealarm/directional/south,
/obj/structure/hedge,
/obj/effect/turf_decal/siding/wood{
	dir = 10
	},
/turf/open/floor/wood/large,
/area/station/command/heads_quarters/nt_rep)
"cK" = (
/obj/structure/cable,
/obj/machinery/atmospherics/pipe/smart/manifold4w/scrubbers/hidden/layer2,
/obj/machinery/atmospherics/pipe/smart/manifold4w/supply/hidden/layer4,
/obj/effect/turf_decal/siding/wood{
	dir = 1
	},
/turf/open/floor/wood/large,
/area/station/command/heads_quarters/nt_rep)
"dk" = (
/obj/structure/sign/flag/nanotrasen/directional/north,
/obj/effect/turf_decal/siding/wood{
	dir = 5
	},
/obj/machinery/photocopier/prebuilt,
/obj/item/toy/plush/skyrat/ian/lisa{
	pixel_y = 11
	},
/turf/open/floor/wood/large,
/area/station/command/heads_quarters/nt_rep)
"dr" = (
/obj/machinery/atmospherics/pipe/smart/manifold4w/scrubbers/hidden/layer2,
/obj/machinery/atmospherics/pipe/smart/manifold4w/supply/hidden/layer4,
/obj/effect/turf_decal/siding/wood{
	dir = 1
	},
/turf/open/floor/wood/large,
/area/station/command/heads_quarters/nt_rep)
"fD" = (
/obj/effect/spawner/structure/window/reinforced,
/obj/structure/cable,
/obj/structure/curtain/cloth/fancy/mechanical{
	icon_state = "bathroom-open";
	icon_type = "bathroom";
	id = "ntc_privatecurtains";
	name = "expensive curtain";
	color = "#2E7DA5";
	desc = "An expensive set of excellent cloth drapes."
	},
/turf/open/floor/plating,
/area/station/command/heads_quarters/nt_rep)
"fX" = (
/turf/open/floor/wood/large,
/area/station/command/heads_quarters/nt_rep)
"hH" = (
/obj/structure/chair/wood{
	dir = 4
	},
/obj/effect/turf_decal/siding/wood{
	dir = 4
	},
/turf/open/floor/wood/large,
/area/station/command/heads_quarters/nt_rep)
"ke" = (
/obj/effect/turf_decal/siding/wood{
	dir = 4
	},
/obj/effect/mapping_helpers/turn_off_lights_with_lightswitch,
/turf/open/floor/wood/large,
/area/station/command/heads_quarters/nt_rep)
"kE" = (
/obj/item/radio/intercom/directional/west,
/obj/machinery/atmospherics/components/unary/vent_pump/on/layer4{
	dir = 4
	},
/obj/machinery/light_switch/directional/south,
/obj/structure/closet/secure_closet/personal/cabinet,
/turf/open/floor/carpet/cyan,
/area/station/command/heads_quarters/nt_rep)
"kK" = (
/obj/effect/turf_decal/trimline/blue/filled/line{
	dir = 4
	},
/obj/effect/turf_decal/trimline/blue/filled/mid_joiner{
	dir = 4
	},
/turf/open/floor/iron/large,
/area/station/hallway/primary/central)
"lz" = (
/turf/closed/wall,
/area/station/hallway/primary/starboard)
"lP" = (
/obj/structure/cable,
/obj/machinery/atmospherics/pipe/smart/manifold4w/supply/hidden/layer4,
/obj/machinery/atmospherics/pipe/smart/manifold4w/scrubbers/hidden/layer2,
/obj/effect/turf_decal/trimline/blue/filled/line{
	dir = 4
	},
/obj/effect/turf_decal/trimline/blue/filled/mid_joiner{
	dir = 4
	},
/turf/open/floor/iron/large,
/area/station/hallway/primary/central)
"lR" = (
/obj/effect/landmark/start/nanotrasen_consultant,
/obj/machinery/newscaster/directional/north,
/obj/machinery/light/small/directional/north,
/turf/open/floor/carpet/cyan,
/area/station/command/heads_quarters/nt_rep)
"nS" = (
/obj/structure/cable,
/obj/machinery/atmospherics/pipe/smart/manifold4w/scrubbers/hidden/layer2,
/obj/machinery/atmospherics/pipe/smart/manifold4w/supply/hidden/layer4,
/obj/effect/turf_decal/siding/wood/corner{
	dir = 4
	},
/turf/open/floor/wood/large,
/area/station/command/heads_quarters/nt_rep)
"oq" = (
/obj/structure/table/reinforced/titaniumglass,
/obj/item/paper_bin{
	pixel_y = 5;
	pixel_x = -4
	},
/obj/item/stamp/granted{
	pixel_y = 12;
	pixel_x = 8
	},
/obj/item/stamp/denied{
	pixel_x = 8;
	pixel_y = 6
	},
/obj/item/pen/fountain/nanotrasen{
	pixel_y = 5;
	pixel_x = -4
	},
/obj/item/stamp/head/ntc{
	pixel_x = 8
	},
/turf/open/floor/carpet/executive,
/area/station/command/heads_quarters/nt_rep)
"pc" = (
/obj/structure/sign/poster/official/enlist/directional/north,
/obj/structure/filingcabinet/medical{
	pixel_x = -10;
	icon_state = "employmentcabinet";
	name = "medical records filing cabinet"
	},
/obj/structure/filingcabinet/employment{
	name = "employment forms filing cabinet"
	},
/obj/structure/filingcabinet/security{
	pixel_x = 10;
	icon_state = "employmentcabinet";
	name = "security records filing cabinet"
	},
/obj/effect/turf_decal/siding/wood{
	dir = 1
	},
/obj/machinery/light/warm/directional/north,
/turf/open/floor/wood/large,
/area/station/command/heads_quarters/nt_rep)
"qe" = (
/obj/machinery/vending/cigarette,
/turf/open/floor/iron,
/area/station/hallway/primary/starboard)
"qg" = (
/obj/effect/landmark/start/nanotrasen_consultant,
/obj/structure/chair/comfy/brown{
	dir = 8
	},
/turf/open/floor/carpet/executive,
/area/station/command/heads_quarters/nt_rep)
"qi" = (
/obj/effect/spawner/random/vending/snackvend,
/turf/open/floor/iron,
/area/station/hallway/primary/starboard)
"qj" = (
/obj/structure/table/reinforced/titaniumglass,
/obj/machinery/fax{
	fax_name = "Nanotrasen Consultant's Office";
	name = "Nanotrasen Consultant's Fax Machine"
	},
/obj/machinery/button/curtain{
	id = "ntc_privatecurtains";
	req_access = list("cent_general");
	pixel_y = 26
	},
/turf/open/floor/carpet/executive,
/area/station/command/heads_quarters/nt_rep)
"qL" = (
/obj/structure/closet/firecloset,
/obj/effect/turf_decal/trimline/blue/filled/line{
	dir = 4
	},
/obj/effect/turf_decal/trimline/blue/filled/mid_joiner{
	dir = 4
	},
/obj/machinery/modular_computer/preset/time_clock/directional/east,
/obj/machinery/camera/autoname/directional/east,
/turf/open/floor/iron/large,
/area/station/hallway/primary/central)
"qZ" = (
/obj/machinery/door/airlock/corporate{
	name = "Consultant's Quarters"
	},
/obj/effect/mapping_helpers/airlock/access/all/cent_com/consultant,
/obj/machinery/atmospherics/pipe/smart/manifold4w/scrubbers/hidden/layer2,
/obj/machinery/atmospherics/pipe/smart/manifold4w/supply/hidden/layer4,
/turf/open/floor/iron/dark/textured_large,
/area/station/command/heads_quarters/nt_rep)
"tA" = (
/obj/effect/spawner/random/vending/colavend,
/turf/open/floor/iron,
/area/station/hallway/primary/starboard)
"vm" = (
/obj/structure/cable,
/obj/machinery/atmospherics/pipe/smart/manifold4w/scrubbers/hidden/layer2,
/obj/machinery/atmospherics/pipe/smart/manifold4w/supply/hidden/layer4,
/obj/effect/turf_decal/siding/wood{
	dir = 8
	},
/turf/open/floor/wood/large,
/area/station/command/heads_quarters/nt_rep)
"vB" = (
/obj/machinery/airalarm/directional/south,
/obj/machinery/atmospherics/components/unary/vent_pump/on/layer4{
	dir = 1
	},
/obj/effect/turf_decal/siding/wood,
/obj/structure/closet/secure_closet/nanotrasen_crew_trainer,
/obj/item/storage/lunchbox/nanotrasen,
/turf/open/floor/wood/large,
/area/station/command/heads_quarters/nt_rep)
"wQ" = (
/obj/structure/chair/comfy/black{
	dir = 8
	},
/obj/effect/landmark/start/nanotrasen_crew_trainer,
/obj/machinery/newscaster/directional/south,
/obj/effect/turf_decal/siding/wood,
/turf/open/floor/wood/large,
/area/station/command/heads_quarters/nt_rep)
"yj" = (
/obj/machinery/atmospherics/pipe/smart/manifold4w/scrubbers/hidden/layer2,
/obj/machinery/atmospherics/pipe/smart/manifold4w/supply/hidden/layer4,
/turf/open/floor/carpet/cyan,
/area/station/command/heads_quarters/nt_rep)
"zB" = (
/obj/structure/table/glass,
/obj/item/hand_labeler,
/obj/effect/decal/cleanable/dirt,
/turf/open/floor/iron,
/area/station/hallway/primary/starboard)
"AE" = (
/obj/structure/closet/secure_closet/nanotrasen_consultant,
/obj/structure/noticeboard/directional/north{
	name = "Nanotrasen Consultant's Notice Board"
	},
/obj/machinery/keycard_auth/wall_mounted/directional/east,
/turf/open/floor/carpet/executive,
/area/station/command/heads_quarters/nt_rep)
"Cd" = (
/obj/machinery/disposal/bin,
/obj/structure/disposalpipe/trunk{
	dir = 8
	},
/obj/effect/turf_decal/trimline/blue/filled/line{
	dir = 4
	},
/obj/effect/turf_decal/trimline/blue/filled/mid_joiner{
	dir = 4
	},
/turf/open/floor/iron/large,
/area/station/hallway/primary/central)
"DP" = (
/turf/closed/wall/r_wall,
/area/station/command/heads_quarters/nt_rep)
"EC" = (
/obj/structure/table/wood,
/obj/item/paper_bin{
	pixel_y = 5;
	pixel_x = -4
	},
/obj/item/stamp/granted{
	pixel_y = 9;
	pixel_x = 8
	},
/obj/item/stamp/denied{
	pixel_x = 8;
	pixel_y = 2
	},
/obj/item/pen{
	pixel_y = 5;
	pixel_x = -4
	},
/obj/effect/turf_decal/siding/wood{
	dir = 5
	},
/turf/open/floor/wood/large,
/area/station/command/heads_quarters/nt_rep)
"Gp" = (
/obj/structure/dresser,
/obj/machinery/atmospherics/components/unary/vent_scrubber/on/layer2{
	dir = 8
	},
/obj/effect/turf_decal/siding/wood/end,
/turf/open/floor/wood/tile,
/area/station/command/heads_quarters/nt_rep)
"GK" = (
/obj/machinery/light_switch/directional/north,
/obj/structure/hedge,
/obj/effect/turf_decal/siding/wood{
	dir = 9
	},
/turf/open/floor/wood/large,
/area/station/command/heads_quarters/nt_rep)
"HW" = (
/obj/structure/table/glass,
/obj/item/paper_bin{
	pixel_x = -2;
	pixel_y = 4
	},
/obj/effect/decal/cleanable/dirt,
/turf/open/floor/iron,
/area/station/hallway/primary/starboard)
"Il" = (
/obj/structure/table/glass,
/turf/open/floor/iron,
/area/station/hallway/primary/starboard)
"Ir" = (
/obj/effect/spawner/random/vending/colavend,
/obj/effect/turf_decal/trimline/green/filled/mid_joiner,
/obj/effect/turf_decal/trimline/blue/filled/line{
	dir = 4
	},
/obj/effect/turf_decal/trimline/blue/filled/mid_joiner{
	dir = 4
	},
/turf/open/floor/iron/large,
/area/station/hallway/primary/central)
"Iv" = (
/obj/structure/sign/calendar/directional/east,
/turf/open/floor/carpet/executive,
/area/station/command/heads_quarters/nt_rep)
"Iw" = (
/obj/machinery/power/apc/auto_name/directional/north,
/obj/structure/cable,
/obj/machinery/atmospherics/pipe/smart/manifold4w/scrubbers/hidden/layer2,
/obj/machinery/atmospherics/pipe/smart/manifold4w/supply/hidden/layer4,
/obj/effect/turf_decal/siding/wood{
	dir = 1
	},
/turf/open/floor/wood/large,
/area/station/command/heads_quarters/nt_rep)
"IS" = (
/turf/closed/wall,
/area/station/hallway/primary/central)
"Jf" = (
/obj/item/radio/intercom/directional/south,
/obj/structure/chair/office{
	dir = 4
	},
/obj/effect/turf_decal/siding/wood,
/obj/machinery/light/warm/directional/south,
/turf/open/floor/wood/large,
/area/station/command/heads_quarters/nt_rep)
"Ld" = (
/obj/structure/sign/clock/directional/south,
/obj/effect/turf_decal/siding/wood,
/obj/structure/aquarium/prefilled,
/obj/item/reagent_containers/cup/fish_feed{
	pixel_y = 17;
	pixel_x = -3
	},
/turf/open/floor/wood/large,
/area/station/command/heads_quarters/nt_rep)
"LP" = (
/obj/structure/table/reinforced/titaniumglass,
/obj/item/clipboard{
	pixel_y = 4;
	pixel_x = -3
	},
/obj/item/folder/nanotrasen{
	pixel_y = 1;
	pixel_x = 1
	},
/obj/item/sign/flag/nanotrasen{
	pixel_x = 5
	},
/turf/open/floor/carpet/executive,
/area/station/command/heads_quarters/nt_rep)
"Mm" = (
/turf/open/floor/iron,
/area/station/hallway/primary/starboard)
"MI" = (
/obj/structure/table/glass,
/obj/item/clothing/head/costume/festive,
/obj/effect/decal/cleanable/dirt,
/turf/open/floor/iron,
/area/station/hallway/primary/starboard)
"NY" = (
/obj/structure/table/glass,
/obj/item/stack/package_wrap,
/obj/effect/decal/cleanable/dirt,
/turf/open/floor/iron,
/area/station/hallway/primary/starboard)
"Ot" = (
/obj/effect/turf_decal/siding/wood{
	dir = 8
	},
/turf/open/floor/wood/large,
/area/station/command/heads_quarters/nt_rep)
"Ou" = (
/obj/structure/bed/dogbed/luxury,
/obj/effect/spawner/random/ntc_pet,
/obj/structure/sign/flag/nanotrasen/directional/south,
/obj/effect/turf_decal/siding/wood,
/obj/machinery/camera/autoname/directional/south,
/turf/open/floor/wood/large,
/area/station/command/heads_quarters/nt_rep)
"OI" = (
/obj/structure/cable,
/obj/machinery/atmospherics/pipe/smart/manifold4w/scrubbers/hidden/layer2,
/obj/machinery/atmospherics/pipe/smart/manifold4w/supply/hidden/layer4,
/turf/open/floor/wood/large,
/area/station/command/heads_quarters/nt_rep)
"QK" = (
/obj/structure/cable,
/obj/machinery/atmospherics/pipe/smart/manifold4w/scrubbers/hidden/layer2,
/obj/machinery/atmospherics/pipe/smart/manifold4w/supply/hidden/layer4,
/obj/machinery/holopad,
/obj/effect/landmark/event_spawn,
/turf/open/floor/wood/large,
/area/station/command/heads_quarters/nt_rep)
"QN" = (
/obj/structure/table/wood,
/obj/structure/sign/clock/directional/north,
/turf/open/floor/carpet/cyan,
/area/station/command/heads_quarters/nt_rep)
"RD" = (
/obj/machinery/vending/coffee,
/obj/machinery/airalarm/directional/west,
/turf/open/floor/iron,
/area/station/hallway/primary/starboard)
"SD" = (
/obj/machinery/atmospherics/components/unary/vent_scrubber/on/layer2{
	dir = 1
	},
/obj/machinery/computer/station_goal{
	dir = 4
	},
/obj/structure/sign/poster/official/nanotrasen_logo/directional/south,
/obj/effect/turf_decal/siding/wood,
/turf/open/floor/wood/large,
/area/station/command/heads_quarters/nt_rep)
"Tu" = (
/obj/structure/table/reinforced/titaniumglass,
/obj/machinery/recharger{
	pixel_y = 3;
	pixel_x = 7
	},
/obj/item/flashlight/lamp/green{
	pixel_y = 13;
	pixel_x = -6
	},
/obj/item/phone{
	pixel_x = -4;
	pixel_y = -1
	},
/obj/item/reagent_containers/cup/glass/mug/nanotrasen{
	pixel_x = 9;
	pixel_y = 17
	},
/turf/open/floor/carpet/executive,
/area/station/command/heads_quarters/nt_rep)
"Ty" = (
/obj/structure/table/wood,
/obj/item/clipboard{
	pixel_y = 3;
	pixel_x = 2
	},
/obj/item/folder/nanotrasen{
	pixel_x = -2;
	pixel_y = 1
	},
/obj/effect/turf_decal/siding/wood{
	dir = 6
	},
/turf/open/floor/wood/large,
/area/station/command/heads_quarters/nt_rep)
"TL" = (
/obj/structure/cable,
/obj/machinery/door/airlock/corporate{
	name = "Nanotrasen Internal Affairs Office"
	},
/obj/machinery/atmospherics/pipe/smart/manifold4w/scrubbers/hidden/layer2,
/obj/machinery/atmospherics/pipe/smart/manifold4w/supply/hidden/layer4,
/obj/machinery/door/firedoor,
/obj/effect/mapping_helpers/airlock/access/all/cent_com/nanotrasenstaff,
/obj/effect/mapping_helpers/airlock/unres{
	dir = 4
	},
/obj/effect/landmark/navigate_destination/autoname,
/turf/open/floor/iron/dark/textured_large,
/area/station/command/heads_quarters/nt_rep)
"TQ" = (
/obj/structure/table/glass,
/obj/item/storage/briefcase/secure,
/obj/effect/decal/cleanable/dirt,
/turf/open/floor/iron,
/area/station/hallway/primary/starboard)
"TV" = (
/obj/machinery/vending/boozeomat{
	density = 0;
	pixel_y = -32
	},
/obj/effect/turf_decal/siding/wood,
/obj/structure/table/wood/fancy/cyan,
/turf/open/floor/wood/large,
/area/station/command/heads_quarters/nt_rep)
"Uo" = (
/obj/machinery/modular_computer/preset/command,
/obj/machinery/requests_console/directional/north{
	department = "Nanotrasen Consultant's Desk";
	name = "Nanotrasen Consultant's Requests Console"
	},
/obj/effect/mapping_helpers/requests_console/assistance,
/obj/effect/mapping_helpers/requests_console/announcement,
/obj/effect/mapping_helpers/requests_console/information,
/turf/open/floor/carpet/executive,
/area/station/command/heads_quarters/nt_rep)
"Uq" = (
/obj/machinery/status_display/evac/directional/east,
/obj/item/folder/ntc_documents,
/obj/structure/safe/floor/ntc,
/obj/item/reagent_containers/cup/glass/flask/gold,
/obj/item/reagent_containers/applicator/pill/cyanide,
/obj/item/photo{
	name = "department group photo";
	desc = "A recent photo of all the Internal Affairs staff, the Affairs Director, Assistant Director, and all the Executive Officers, and Crew Trainers. You almost miss the good days.."
	},
/obj/item/reagent_containers/cup/glass/bottle/rum/aged,
/obj/item/gun/energy/pulse/pistol/m1911/fake_ntc,
/obj/item/toy/figure/dsquad,
/obj/item/coin/adamantine,
/obj/item/encryptionkey/headset_cent,
/obj/machinery/light/warm/directional/east,
/turf/open/floor/carpet/executive,
/area/station/command/heads_quarters/nt_rep)
"UQ" = (
/obj/structure/table/glass,
/obj/effect/decal/cleanable/dirt,
/turf/open/floor/iron,
/area/station/hallway/primary/starboard)
"Vm" = (
/obj/structure/bed/double{
	dir = 8
	},
/obj/item/bedsheet/ntc/double,
/obj/effect/turf_decal/siding/wood/end{
	dir = 1
	},
/obj/machinery/airalarm/directional/north,
/turf/open/floor/wood/tile,
/area/station/command/heads_quarters/nt_rep)
"Xm" = (
/obj/machinery/light/warm/directional/south,
/obj/structure/chair/comfy/black{
	dir = 4
	},
/obj/effect/landmark/start/nanotrasen_consultant,
/obj/structure/extinguisher_cabinet/directional/south,
/obj/effect/turf_decal/siding/wood,
/turf/open/floor/wood/large,
/area/station/command/heads_quarters/nt_rep)

(1,1,1) = {"
lz
qL
Cd
kK
lP
kK
Ir
IS
"}
(2,1,1) = {"
lz
DP
fD
fD
TL
fD
fD
DP
"}
(3,1,1) = {"
MI
DP
GK
Ot
vm
Ot
bT
DP
"}
(4,1,1) = {"
TQ
DP
pc
fX
QK
OI
Xm
DP
"}
(5,1,1) = {"
NY
DP
dk
hH
ke
nS
TV
DP
"}
(6,1,1) = {"
UQ
DP
qj
LP
Tu
cK
wQ
DP
"}
(7,1,1) = {"
zB
DP
Uo
qg
oq
cK
Ou
DP
"}
(8,1,1) = {"
HW
DP
AE
Uq
Iv
cK
Ld
DP
"}
(9,1,1) = {"
Il
DP
DP
DP
DP
cK
vB
DP
"}
(10,1,1) = {"
Il
DP
QN
kE
DP
Iw
SD
DP
"}
(11,1,1) = {"
Il
DP
lR
yj
qZ
dr
Jf
DP
"}
(12,1,1) = {"
aA
DP
Vm
Gp
DP
EC
Ty
DP
"}
(13,1,1) = {"
lz
DP
DP
DP
DP
DP
DP
DP
"}
(14,1,1) = {"
lz
qe
RD
Mm
Mm
tA
qi
lz
"}
