//MAP CONVERTED BY dmm2tgm.py THIS HEADER COMMENT PREVENTS RECONVERSION, DO NOT REMOVE
"a" = (
/turf/closed/wall/r_wall,
/area/station/security/warden)
"c" = (
/turf/closed/wall/r_wall,
/area/station/security/holding_cell)
"d" = (
/obj/structure/closet/secure_closet/security_medic,
/obj/effect/turf_decal/trimline/blue/filled/line{
	dir = 8
	},
/obj/machinery/firealarm/directional/west,
/turf/open/floor/iron/white/smooth_edge{
	dir = 4
	},
/area/station/security/medical)
"p" = (
/obj/structure/cable,
/obj/effect/turf_decal/trimline/blue/filled/line{
	dir = 4
	},
/obj/effect/turf_decal/trimline/blue/filled/corner{
	dir = 8
	},
/obj/effect/turf_decal/stripes/line,
/obj/machinery/door/window/brigdoor/left/directional/south{
	name = "Security Medical";
	req_access = list("brig")
	},
/obj/machinery/door/firedoor/border_only,
/turf/open/floor/iron/white,
/area/station/security/medical)
"q" = (
/obj/structure/closet/generic/wall/empty{
	pixel_x = -32;
	pixel_y = 0
	},
/obj/item/reagent_containers/spray/cleaner,
/obj/item/storage/box/bandages,
/obj/item/reagent_containers/syringe,
/obj/item/reagent_containers/cup/bottle/epinephrine,
/obj/item/reagent_containers/cup/bottle/multiver,
/obj/item/storage/medkit/regular,
/obj/structure/table/reinforced,
/obj/machinery/computer/records/medical/laptop{
	dir = 4;
	pixel_x = 3;
	pixel_y = 2
	},
/obj/item/clothing/gloves/latex,
/obj/effect/turf_decal/trimline/blue/filled/line{
	dir = 8
	},
/turf/open/floor/iron/white/smooth_edge{
	dir = 4
	},
/area/station/security/medical)
"s" = (
/obj/structure/window/reinforced/spawner/directional/south,
/obj/machinery/atmospherics/components/unary/vent_scrubber/on/layer2,
/obj/machinery/light_switch/directional/west,
/obj/structure/table/reinforced,
/obj/item/folder/red{
	pixel_x = 11;
	pixel_y = 2
	},
/obj/item/folder/white{
	pixel_x = 7;
	pixel_y = 2
	},
/obj/item/paper_bin{
	pixel_x = -7;
	pixel_y = 3
	},
/obj/item/pen{
	pixel_y = 3;
	pixel_x = -8
	},
/obj/item/healthanalyzer{
	pixel_x = -6;
	pixel_y = 17
	},
/obj/item/reagent_containers/cup/glass/mug/nanotrasen{
	pixel_x = 9;
	pixel_y = 15
	},
/obj/effect/turf_decal/trimline/blue/filled/line{
	dir = 10
	},
/obj/machinery/door/firedoor/border_only,
/turf/open/floor/iron/white,
/area/station/security/medical)
"t" = (
/obj/machinery/airalarm/directional/west,
/obj/machinery/vending/wallmed/directional/north,
/obj/machinery/camera/directional/north{
	c_tag = "Security - Medbay"
	},
/obj/machinery/computer/operating{
	dir = 4
	},
/obj/effect/turf_decal/trimline/blue/filled/line{
	dir = 9
	},
/turf/open/floor/iron/white,
/area/station/security/medical)
"x" = (
/obj/structure/chair/office/light,
/obj/effect/landmark/start/security_medic,
/turf/open/floor/iron/white/smooth_large,
/area/station/security/medical)
"y" = (
/obj/machinery/atmospherics/components/unary/vent_pump/on/layer4,
/obj/structure/window/reinforced/spawner/directional/south,
/obj/structure/table/reinforced,
/obj/machinery/computer/crew{
	dir = 1
	},
/obj/effect/turf_decal/trimline/blue/filled/line,
/obj/machinery/door/firedoor/border_only,
/turf/open/floor/iron/white/smooth_edge{
	dir = 1
	},
/area/station/security/medical)
"D" = (
/obj/structure/table/optable,
/obj/structure/sink/directional/south,
/obj/effect/turf_decal/trimline/blue/filled/line{
	dir = 1
	},
/turf/open/floor/iron/white/smooth_edge,
/area/station/security/medical)
"E" = (
/turf/closed/wall,
/area/station/security/medical)
"G" = (
/obj/structure/cable,
/obj/machinery/power/apc/auto_name/directional/east,
/obj/effect/turf_decal/trimline/blue/filled/line{
	dir = 4
	},
/turf/open/floor/iron/white/smooth_edge{
	dir = 8
	},
/area/station/security/medical)
"I" = (
/obj/machinery/stasis,
/obj/machinery/wall_healer/directional/east,
/obj/machinery/iv_drip,
/obj/item/bedsheet/medical,
/obj/effect/turf_decal/trimline/blue/filled/line{
	dir = 4
	},
/turf/open/floor/iron/white/smooth_edge{
	dir = 8
	},
/area/station/security/medical)
"L" = (
/turf/closed/wall/r_wall,
/area/station/security/detectives_office)
"Q" = (
/obj/item/radio/intercom/directional/east,
/obj/structure/table/reinforced/rglass,
/obj/effect/spawner/surgery_tray/full,
/obj/machinery/light/cold/directional/east,
/obj/effect/turf_decal/trimline/blue/filled/line{
	dir = 5
	},
/obj/machinery/defibrillator_mount/directional/north,
/turf/open/floor/iron/white,
/area/station/security/medical)
"S" = (
/obj/machinery/holopad,
/obj/effect/turf_decal/bot,
/obj/effect/landmark/event_spawn,
/obj/effect/landmark/start/security_medic,
/turf/open/floor/iron/white/smooth_large,
/area/station/security/medical)
"W" = (
/turf/closed/wall,
/area/station/security/holding_cell)

(1,1,1) = {"
L
c
W
W
W
"}
(2,1,1) = {"
a
t
d
q
s
"}
(3,1,1) = {"
a
D
S
x
y
"}
(4,1,1) = {"
a
Q
I
G
p
"}
(5,1,1) = {"
a
a
a
a
E
"}
