//MAP CONVERTED BY dmm2tgm.py THIS HEADER COMMENT PREVENTS RECONVERSION, DO NOT REMOVE
"a" = (
/obj/structure/table/wood,
/obj/item/clipboard{
	pixel_y = 3;
	pixel_x = 6
	},
/obj/effect/turf_decal/siding/wood{
	dir = 8
	},
/obj/machinery/status_display/evac/directional/west,
/obj/item/table_clock{
	pixel_y = 16;
	pixel_x = -9
	},
/obj/item/folder/nanotrasen{
	pixel_x = -2;
	pixel_y = 1
	},
/turf/open/floor/wood/large,
/area/station/command/heads_quarters/nt_rep)
"b" = (
/obj/machinery/digital_clock{
	pixel_y = 5
	},
/turf/closed/wall/r_wall,
/area/station/command/heads_quarters/nt_rep)
"c" = (
/obj/structure/cable,
/obj/structure/chair/office{
	dir = 8
	},
/obj/effect/landmark/start/nanotrasen_crew_trainer,
/turf/open/floor/wood/large,
/area/station/command/heads_quarters/nt_rep)
"d" = (
/obj/structure/flora/grass/jungle,
/obj/structure/flora/bush/grassy,
/obj/structure/flora/bush/flowers_br,
/obj/structure/window/reinforced/fulltile,
/obj/structure/cable,
/obj/structure/curtain/cloth/fancy/mechanical{
	icon_state = "bathroom-open";
	icon_type = "bathroom";
	id = "ntc_privatecurtains";
	name = "expensive curtain";
	color = "#2E7DA5";
	desc = "An expensive set of excellent cloth drapes."
	},
/turf/open/floor/grass,
/area/station/command/heads_quarters/nt_rep)
"f" = (
/turf/closed/wall/r_wall,
/area/station/command/heads_quarters/nt_rep)
"g" = (
/obj/structure/table/reinforced/titaniumglass,
/obj/item/flashlight/lamp/green{
	pixel_y = 13;
	pixel_x = -6
	},
/obj/item/phone{
	pixel_x = -4;
	pixel_y = -1
	},
/obj/machinery/recharger{
	pixel_y = 3;
	pixel_x = 7
	},
/obj/structure/cable,
/turf/open/floor/carpet/executive,
/area/station/command/heads_quarters/nt_rep)
"h" = (
/obj/structure/noticeboard/directional/south{
	name = "Nanotrasen Consultant's Notice Board"
	},
/turf/open/floor/carpet/executive,
/area/station/command/heads_quarters/nt_rep)
"i" = (
/obj/structure/table/reinforced/titaniumglass,
/obj/item/clipboard{
	pixel_y = 3;
	pixel_x = -5
	},
/obj/item/folder/nanotrasen{
	pixel_y = 2;
	pixel_x = -4
	},
/obj/item/reagent_containers/cup/glass/mug/nanotrasen{
	pixel_y = 11;
	pixel_x = 11
	},
/obj/item/sign/flag/nanotrasen{
	pixel_x = 5
	},
/turf/open/floor/carpet/executive,
/area/station/command/heads_quarters/nt_rep)
"k" = (
/obj/machinery/atmospherics/pipe/smart/manifold4w/scrubbers/hidden/layer2,
/obj/machinery/atmospherics/pipe/smart/manifold4w/supply/hidden/layer4,
/obj/effect/turf_decal/siding/wood,
/obj/structure/chair/wood,
/turf/open/floor/wood/large,
/area/station/command/heads_quarters/nt_rep)
"m" = (
/obj/effect/spawner/structure/window/reinforced,
/obj/structure/cable,
/obj/structure/curtain/cloth/fancy/mechanical{
	icon_state = "bathroom-open";
	icon_type = "bathroom";
	id = "ntc_privatecurtains";
	name = "expensive curtain";
	color = "#2E7DA5";
	desc = "An expensive set of excellent cloth drapes."
	},
/turf/open/floor/plating,
/area/station/command/heads_quarters/nt_rep)
"n" = (
/obj/machinery/atmospherics/pipe/smart/manifold4w/supply/hidden/layer4,
/obj/machinery/firealarm/directional/north,
/obj/machinery/light/warm/directional/north,
/obj/machinery/atmospherics/pipe/smart/manifold4w/scrubbers/hidden/layer2,
/obj/effect/turf_decal/siding/wood/end{
	dir = 4
	},
/turf/open/floor/wood/large,
/area/station/command/heads_quarters/nt_rep)
"o" = (
/obj/structure/chair/comfy/brown{
	dir = 1
	},
/obj/effect/landmark/start/nanotrasen_consultant,
/turf/open/floor/carpet/executive,
/area/station/command/heads_quarters/nt_rep)
"p" = (
/obj/structure/cable,
/obj/machinery/power/apc/auto_name/directional/east,
/obj/effect/turf_decal/siding/wood{
	dir = 6
	},
/obj/structure/bed/dogbed/ian{
	name = "Lisa's bed";
	desc = "Lisa's bed! Looks comfy."
	},
/mob/living/basic/pet/dog/corgi/lisa,
/turf/open/floor/wood/large,
/area/station/command/heads_quarters/nt_rep)
"s" = (
/obj/machinery/atmospherics/pipe/smart/manifold4w/supply/hidden/layer4,
/obj/machinery/atmospherics/pipe/smart/manifold4w/scrubbers/hidden/layer2,
/obj/effect/turf_decal/siding/wood{
	dir = 8
	},
/obj/effect/turf_decal/siding/wood{
	dir = 4
	},
/turf/open/floor/wood/large,
/area/station/command/heads_quarters/nt_rep)
"u" = (
/turf/closed/wall,
/area/station/command/heads_quarters/nt_rep)
"v" = (
/obj/effect/turf_decal/siding/wood{
	dir = 8
	},
/obj/effect/turf_decal/siding/wood{
	dir = 4
	},
/obj/machinery/atmospherics/pipe/smart/manifold4w/scrubbers/hidden/layer2,
/obj/machinery/atmospherics/pipe/smart/manifold4w/supply/hidden/layer4,
/obj/machinery/firealarm/directional/west,
/turf/open/floor/wood/large,
/area/station/command/heads_quarters/nt_rep)
"w" = (
/obj/machinery/light/directional/south,
/obj/machinery/keycard_auth/wall_mounted/directional/south{
	pixel_x = -6
	},
/obj/structure/safe/floor/ntc,
/obj/item/folder/ntc_documents,
/obj/machinery/button/curtain{
	id = "ntc_privatecurtains";
	pixel_x = 7;
	req_access = list("cent_captain");
	pixel_y = -26
	},
/obj/item/reagent_containers/cup/glass/flask/gold,
/obj/item/reagent_containers/applicator/pill/cyanide,
/obj/item/photo{
	name = "department group photo";
	desc = "A recent photo of all the Internal Affairs staff, the Affairs Director, Assistant Director, and all the Executive Officers, and Crew Trainers. You almost miss the good days.."
	},
/obj/item/reagent_containers/cup/glass/bottle/rum/aged,
/obj/item/gun/energy/pulse/pistol/m1911/fake_ntc,
/obj/item/toy/figure/dsquad,
/obj/item/coin/adamantine,
/obj/item/encryptionkey/headset_cent,
/turf/open/floor/carpet/executive,
/area/station/command/heads_quarters/nt_rep)
"x" = (
/obj/structure/bed/double,
/obj/machinery/airalarm/directional/south,
/obj/item/bedsheet/ntc/double,
/turf/open/floor/carpet/cyan,
/area/station/command/heads_quarters/nt_rep)
"y" = (
/obj/structure/dresser,
/obj/item/sign/flag/nanotrasen{
	pixel_x = 1;
	pixel_y = 12
	},
/obj/item/radio/intercom/directional/west,
/turf/open/floor/carpet/cyan,
/area/station/command/heads_quarters/nt_rep)
"z" = (
/obj/machinery/modular_computer/preset/command{
	dir = 8
	},
/turf/open/floor/carpet/executive,
/area/station/command/heads_quarters/nt_rep)
"A" = (
/obj/structure/cable,
/obj/machinery/atmospherics/pipe/smart/manifold4w/supply/hidden/layer4,
/obj/machinery/atmospherics/pipe/smart/manifold4w/scrubbers/hidden/layer2,
/obj/effect/turf_decal/siding/wood{
	dir = 4
	},
/obj/structure/disposalpipe/segment{
	dir = 5
	},
/turf/open/floor/wood/large,
/area/station/command/heads_quarters/nt_rep)
"B" = (
/obj/item/paper_bin{
	pixel_y = 5;
	pixel_x = -4
	},
/obj/item/stamp{
	pixel_y = 12;
	pixel_x = 8
	},
/obj/item/stamp/denied{
	pixel_x = 8;
	pixel_y = 6
	},
/obj/structure/table/reinforced/titaniumglass,
/obj/item/pen/fountain/nanotrasen{
	pixel_y = 5;
	pixel_x = -4
	},
/obj/item/stamp/head/ntc{
	pixel_x = 8
	},
/turf/open/floor/carpet/executive,
/area/station/command/heads_quarters/nt_rep)
"C" = (
/obj/machinery/atmospherics/pipe/smart/manifold4w/supply/hidden/layer4,
/obj/machinery/atmospherics/pipe/smart/manifold4w/scrubbers/hidden/layer2,
/obj/structure/cable,
/obj/machinery/holopad,
/obj/effect/landmark/start/nanotrasen_crew_trainer,
/turf/open/floor/wood/large,
/area/station/command/heads_quarters/nt_rep)
"D" = (
/obj/effect/turf_decal/siding/wood/end,
/obj/structure/sign/poster/official/enlist/directional/south,
/obj/machinery/vending/boozeomat{
	density = 0;
	req_access = list("cent_general");
	pixel_x = -32
	},
/turf/open/floor/wood/large,
/area/station/command/heads_quarters/nt_rep)
"E" = (
/obj/effect/turf_decal/siding/wood,
/obj/machinery/atmospherics/pipe/smart/manifold4w/scrubbers/hidden/layer2,
/obj/machinery/atmospherics/pipe/smart/manifold4w/supply/hidden/layer4,
/turf/open/floor/wood/large,
/area/station/command/heads_quarters/nt_rep)
"F" = (
/obj/structure/table/reinforced/titaniumglass,
/obj/machinery/fax{
	fax_name = "Nanotrasen Consultant's Office";
	name = "Nanotrasen Consultant's Fax Machine"
	},
/turf/open/floor/carpet/executive,
/area/station/command/heads_quarters/nt_rep)
"G" = (
/obj/structure/flora/grass/jungle,
/obj/structure/flora/bush/grassy,
/obj/structure/flora/bush/sunny,
/obj/structure/flora/bush/flowers_pp,
/obj/structure/window/reinforced/fulltile,
/obj/structure/cable,
/obj/structure/curtain/cloth/fancy/mechanical{
	icon_state = "bathroom-open";
	icon_type = "bathroom";
	id = "ntc_privatecurtains";
	name = "expensive curtain";
	color = "#2E7DA5";
	desc = "An expensive set of excellent cloth drapes."
	},
/turf/open/floor/grass,
/area/station/command/heads_quarters/nt_rep)
"I" = (
/obj/effect/turf_decal/siding/wood{
	dir = 4
	},
/obj/machinery/light_switch/directional/east,
/obj/structure/disposalpipe/segment,
/obj/machinery/photocopier/prebuilt,
/obj/item/toy/plush/skyrat/ian/lisa{
	pixel_y = 11
	},
/turf/open/floor/wood/large,
/area/station/command/heads_quarters/nt_rep)
"J" = (
/obj/structure/table/wood,
/obj/effect/turf_decal/siding/wood{
	dir = 9
	},
/obj/item/paper_bin{
	pixel_y = 5;
	pixel_x = -4
	},
/obj/item/pen{
	pixel_y = 5;
	pixel_x = -4
	},
/obj/item/stamp{
	pixel_y = 9;
	pixel_x = 8
	},
/obj/item/stamp/denied{
	pixel_x = 8;
	pixel_y = 2
	},
/obj/structure/extinguisher_cabinet/directional/west,
/turf/open/floor/wood/large,
/area/station/command/heads_quarters/nt_rep)
"K" = (
/obj/machinery/atmospherics/components/unary/vent_scrubber/on/layer2{
	dir = 1
	},
/obj/effect/landmark/start/nanotrasen_consultant,
/turf/open/floor/carpet/cyan,
/area/station/command/heads_quarters/nt_rep)
"L" = (
/obj/effect/turf_decal/siding/wood{
	dir = 8
	},
/obj/machinery/airalarm/directional/west,
/obj/structure/closet/secure_closet/nanotrasen_crew_trainer,
/turf/open/floor/wood/large,
/area/station/command/heads_quarters/nt_rep)
"M" = (
/turf/template_noop,
/area/template_noop)
"N" = (
/obj/effect/turf_decal/siding/wood{
	dir = 5
	},
/obj/machinery/disposal/bin,
/obj/structure/disposalpipe/trunk,
/obj/structure/sign/clock/directional/north,
/turf/open/floor/wood/large,
/area/station/command/heads_quarters/nt_rep)
"O" = (
/obj/machinery/door/firedoor,
/obj/structure/cable,
/obj/machinery/atmospherics/pipe/smart/manifold4w/supply/hidden/layer4,
/obj/machinery/atmospherics/pipe/smart/manifold4w/scrubbers/hidden/layer2,
/obj/structure/disposalpipe/segment{
	dir = 4
	},
/obj/machinery/door/airlock/corporate{
	name = "Nanotrasen Internal Affairs Office"
	},
/obj/effect/landmark/navigate_destination/autoname,
/obj/effect/mapping_helpers/airlock/unres{
	dir = 8
	},
/obj/effect/mapping_helpers/airlock/access/all/cent_com/nanotrasenstaff,
/turf/open/floor/iron/dark/textured_large,
/area/station/command/heads_quarters/nt_rep)
"P" = (
/obj/structure/cable,
/obj/effect/mapping_helpers/turn_off_lights_with_lightswitch,
/turf/open/floor/wood/large,
/area/station/command/heads_quarters/nt_rep)
"Q" = (
/obj/machinery/atmospherics/pipe/smart/manifold4w/supply/hidden/layer4,
/obj/effect/turf_decal/siding/wood/end{
	dir = 8
	},
/obj/structure/closet/secure_closet/personal/cabinet,
/obj/machinery/computer/security/telescreen/entertainment/directional/north,
/obj/machinery/light_switch/directional/west,
/turf/open/floor/wood/large,
/area/station/command/heads_quarters/nt_rep)
"S" = (
/obj/effect/turf_decal/siding/wood{
	dir = 1
	},
/obj/structure/sign/calendar/directional/north,
/obj/machinery/light/directional/north,
/obj/structure/filingcabinet/medical{
	pixel_x = -10;
	icon_state = "employmentcabinet";
	name = "medical records filing cabinet"
	},
/obj/structure/filingcabinet/employment{
	name = "employment forms filing cabinet"
	},
/obj/structure/filingcabinet/security{
	pixel_x = 10;
	icon_state = "employmentcabinet";
	name = "security records filing cabinet"
	},
/turf/open/floor/wood/large,
/area/station/command/heads_quarters/nt_rep)
"T" = (
/obj/structure/flora/grass/jungle,
/obj/structure/flora/bush/grassy,
/obj/structure/flora/bush/flowers_yw,
/obj/structure/window/reinforced/fulltile,
/obj/structure/cable,
/obj/structure/curtain/cloth/fancy/mechanical{
	icon_state = "bathroom-open";
	icon_type = "bathroom";
	id = "ntc_privatecurtains";
	name = "expensive curtain";
	color = "#2E7DA5";
	desc = "An expensive set of excellent cloth drapes."
	},
/turf/open/floor/grass,
/area/station/command/heads_quarters/nt_rep)
"U" = (
/obj/machinery/camera/autoname/directional/west,
/obj/effect/turf_decal/siding/wood{
	dir = 8
	},
/obj/effect/turf_decal/siding/wood/corner,
/obj/machinery/atmospherics/pipe/smart/manifold4w/scrubbers/hidden/layer2,
/obj/machinery/atmospherics/pipe/smart/manifold4w/supply/hidden/layer4,
/obj/machinery/newscaster/directional/west,
/turf/open/floor/wood/large,
/area/station/command/heads_quarters/nt_rep)
"V" = (
/obj/machinery/atmospherics/pipe/smart/manifold4w/supply/hidden/layer4,
/obj/machinery/atmospherics/pipe/smart/manifold4w/scrubbers/hidden/layer2,
/obj/machinery/door/firedoor,
/obj/effect/mapping_helpers/airlock/access/all/cent_com/consultant,
/obj/machinery/door/airlock/corporate{
	name = "Consultant's Quarters"
	},
/turf/open/floor/iron/dark/textured_large,
/area/station/command/heads_quarters/nt_rep)
"W" = (
/obj/machinery/atmospherics/components/unary/vent_pump/on/layer4,
/turf/open/floor/wood/large,
/area/station/command/heads_quarters/nt_rep)
"X" = (
/obj/effect/turf_decal/siding/wood{
	dir = 1
	},
/obj/structure/cable,
/obj/machinery/computer/station_goal,
/turf/open/floor/wood/large,
/area/station/command/heads_quarters/nt_rep)
"Y" = (
/obj/machinery/atmospherics/components/unary/vent_pump/on/layer4{
	dir = 1
	},
/obj/structure/sign/clock/directional/west,
/obj/machinery/light/directional/west,
/turf/open/floor/carpet/cyan,
/area/station/command/heads_quarters/nt_rep)
"Z" = (
/obj/structure/closet/secure_closet/nanotrasen_consultant,
/obj/machinery/requests_console/directional/south{
	name = "Nanotrasen Consultant's Requests Console";
	department = "Nanotrasen Consultant's Desk"
	},
/obj/effect/mapping_helpers/requests_console/information,
/obj/effect/mapping_helpers/requests_console/announcement,
/obj/effect/mapping_helpers/requests_console/assistance,
/turf/open/floor/carpet/executive,
/area/station/command/heads_quarters/nt_rep)

(1,1,1) = {"
M
M
M
M
M
f
f
f
f
f
"}
(2,1,1) = {"
M
M
M
M
M
f
Q
Y
y
f
"}
(3,1,1) = {"
M
M
M
M
M
f
n
K
x
f
"}
(4,1,1) = {"
f
f
f
f
f
f
V
u
f
f
"}
(5,1,1) = {"
m
J
a
L
U
v
s
D
f
M
"}
(6,1,1) = {"
m
X
c
P
E
F
B
h
f
M
"}
(7,1,1) = {"
f
S
W
C
k
i
o
w
f
M
"}
(8,1,1) = {"
f
N
I
A
p
g
z
Z
f
M
"}
(9,1,1) = {"
f
b
f
O
f
T
G
d
f
M
"}
