//MAP CONVERTED BY dmm2tgm.py THIS HEADER COMMENT PREVENTS RECONVERSION, DO NOT REMOVE
"a" = (
/turf/closed/wall/r_wall,
/area/station/security/medical)
"b" = (
/obj/machinery/atmospherics/pipe/smart/manifold4w/scrubbers/hidden/layer2,
/obj/structure/cable,
/obj/structure/cable,
/turf/open/floor/iron/white,
/area/station/security/medical)
"e" = (
/obj/machinery/camera/directional/north{
	c_tag = "Security - Medbay"
	},
/obj/effect/turf_decal/siding/dark_red,
/obj/effect/turf_decal/tile/neutral/half/contrasted{
	dir = 1
	},
/obj/structure/table/reinforced/rglass,
/obj/effect/spawner/surgery_tray/full,
/obj/machinery/wall_healer/directional/north,
/turf/open/floor/iron/dark,
/area/station/security/medical)
"h" = (
/obj/effect/spawner/structure/window/reinforced,
/obj/structure/cable,
/turf/open/floor/plating,
/area/station/security/medical)
"m" = (
/obj/effect/turf_decal/tile/blue/anticorner{
	dir = 8
	},
/obj/structure/window/reinforced/spawner/directional/south,
/obj/machinery/computer/records/medical{
	dir = 1
	},
/obj/item/radio/intercom/directional/west,
/turf/open/floor/iron/white/corner{
	dir = 4
	},
/area/station/security/medical)
"o" = (
/obj/structure/cable,
/obj/effect/turf_decal/tile/blue/half{
	dir = 8
	},
/turf/open/floor/iron/white/side{
	dir = 4
	},
/area/station/security/medical)
"t" = (
/obj/effect/turf_decal/trimline/neutral/mid_joiner{
	dir = 8
	},
/obj/effect/turf_decal/tile/neutral/fourcorners,
/obj/machinery/computer/operating{
	dir = 2
	},
/obj/machinery/defibrillator_mount/directional/north,
/obj/structure/sign/poster/official/cleanliness/directional/west,
/turf/open/floor/iron/dark,
/area/station/security/medical)
"u" = (
/obj/machinery/atmospherics/components/unary/vent_pump/on/layer4,
/obj/effect/turf_decal/tile/blue/half{
	dir = 1
	},
/turf/open/floor/iron/white/side,
/area/station/security/medical)
"w" = (
/obj/effect/turf_decal/siding/dark_red,
/obj/effect/turf_decal/tile/neutral/half/contrasted{
	dir = 1
	},
/obj/structure/sink/directional/east,
/obj/machinery/airalarm/directional/west,
/turf/open/floor/iron/dark,
/area/station/security/medical)
"B" = (
/obj/item/storage/medkit/regular{
	pixel_x = 3;
	pixel_y = 6
	},
/obj/item/reagent_containers/spray/cleaner{
	pixel_x = -12;
	pixel_y = 9
	},
/obj/effect/turf_decal/siding/dark_red,
/obj/effect/turf_decal/tile/neutral/half/contrasted{
	dir = 1
	},
/obj/structure/table/reinforced/rglass,
/obj/machinery/status_display/ai/directional/north,
/turf/open/floor/iron/dark,
/area/station/security/medical)
"D" = (
/obj/machinery/light/cold/directional/east,
/obj/effect/turf_decal/tile/blue/anticorner{
	dir = 4
	},
/obj/structure/table/reinforced/rglass,
/obj/item/paper_bin{
	pixel_x = 8;
	pixel_y = 14
	},
/obj/item/folder/red{
	pixel_x = 4;
	pixel_y = -6
	},
/obj/item/folder/white{
	pixel_x = 9;
	pixel_y = -6
	},
/obj/item/pen{
	pixel_x = 8;
	pixel_y = 16
	},
/obj/item/reagent_containers/cup/glass/mug/nanotrasen{
	pixel_x = -5;
	pixel_y = 17
	},
/obj/machinery/newscaster/directional/east,
/turf/open/floor/iron/white/corner{
	dir = 8
	},
/area/station/security/medical)
"F" = (
/obj/effect/turf_decal/tile/blue/half,
/obj/structure/window/reinforced/spawner/directional/south,
/obj/machinery/computer/crew{
	dir = 1
	},
/turf/open/floor/iron/white/side{
	dir = 1
	},
/area/station/security/medical)
"H" = (
/obj/machinery/atmospherics/pipe/smart/manifold4w/supply/hidden/layer4,
/obj/machinery/atmospherics/pipe/smart/manifold4w/scrubbers/hidden/layer2,
/obj/effect/turf_decal/tile/blue/half,
/obj/effect/turf_decal/stripes/line,
/obj/machinery/door/window/brigdoor/right/directional/south{
	req_access = list("security");
	name = "Security Infirmary"
	},
/obj/structure/cable,
/obj/machinery/door/firedoor/border_only{
	pixel_x = 0;
	pixel_y = -1
	},
/turf/open/floor/iron/white/side{
	dir = 1
	},
/area/station/security/medical)
"I" = (
/obj/machinery/power/apc/auto_name/directional/west,
/obj/structure/cable,
/obj/effect/turf_decal/tile/blue/anticorner{
	dir = 1
	},
/obj/machinery/stasis{
	dir = 4
	},
/obj/machinery/iv_drip,
/obj/item/bedsheet/medical{
	dir = 4
	},
/turf/open/floor/iron/white/corner,
/area/station/security/medical)
"J" = (
/obj/machinery/atmospherics/pipe/smart/manifold4w/supply/hidden/layer4,
/obj/machinery/atmospherics/pipe/smart/manifold4w/scrubbers/hidden/layer2,
/obj/structure/cable,
/turf/open/floor/iron/white,
/area/station/security/medical)
"K" = (
/obj/machinery/light_switch/directional/east{
	pixel_y = 5
	},
/obj/machinery/firealarm/directional/east{
	pixel_y = -5
	},
/obj/effect/turf_decal/tile/blue/half{
	dir = 4
	},
/obj/structure/table/reinforced/rglass,
/obj/item/reagent_containers/syringe{
	pixel_x = -5;
	pixel_y = -4
	},
/obj/item/reagent_containers/cup/bottle/epinephrine{
	pixel_x = 0;
	pixel_y = 8
	},
/obj/item/reagent_containers/cup/bottle/multiver{
	pixel_x = 8;
	pixel_y = 8
	},
/turf/open/floor/iron/white/side{
	dir = 8
	},
/area/station/security/medical)
"M" = (
/turf/template_noop,
/area/template_noop)
"N" = (
/obj/machinery/atmospherics/components/unary/vent_scrubber/on/layer2,
/obj/effect/turf_decal/tile/blue/half{
	dir = 1
	},
/obj/structure/chair/office/light{
	dir = 4
	},
/obj/effect/landmark/start/security_medic,
/turf/open/floor/iron/white/side,
/area/station/security/medical)
"O" = (
/obj/effect/turf_decal/trimline/neutral/mid_joiner{
	dir = 4
	},
/obj/effect/turf_decal/tile/neutral/fourcorners,
/obj/structure/table/optable,
/obj/machinery/vitals_reader/directional/north,
/turf/open/floor/iron/dark,
/area/station/security/medical)
"R" = (
/obj/effect/turf_decal/tile/blue/anticorner,
/obj/structure/window/reinforced/spawner/directional/south,
/obj/structure/closet/secure_closet/security_medic,
/turf/open/floor/iron/white/corner{
	dir = 1
	},
/area/station/security/medical)
"V" = (
/obj/effect/turf_decal/siding/dark_red,
/obj/effect/turf_decal/tile/neutral/half/contrasted{
	dir = 1
	},
/obj/effect/landmark/start/security_medic,
/turf/open/floor/iron/dark,
/area/station/security/medical)

(1,1,1) = {"
a
a
a
a
h
a
"}
(2,1,1) = {"
a
t
w
I
o
m
"}
(3,1,1) = {"
a
O
V
u
J
F
"}
(4,1,1) = {"
a
a
e
N
b
H
"}
(5,1,1) = {"
M
a
B
D
K
R
"}
(6,1,1) = {"
M
a
a
a
a
a
"}
