//MAP CONVERTED BY dmm2tgm.py THIS HEADER COMMENT PREVENTS RECONVERSION, DO NOT REMOVE
"ab" = (
/turf/open/space/bluespace,
/area/misc/condo)
"ah" = (
/turf/closed/indestructible/steel,
/area/misc/condo)
"ai" = (
/obj/machinery/telecomms/relay/preset/auto,
/turf/open/floor/catwalk_floor,
/area/misc/condo)
"ao" = (
/obj/machinery/vending/dorms,
/turf/open/floor/wood/tile,
/area/misc/condo)
"ap" = (
/obj/machinery/door/morgue,
/turf/open/floor/wood/tile,
/area/misc/condo)
"aD" = (
/turf/open/floor/carpet,
/area/misc/condo)
"aE" = (
/obj/item/kirbyplants/random,
/obj/effect/turf_decal/siding/wood{
	dir = 4
	},
/turf/open/floor/wood/tile,
/area/misc/condo)
"aF" = (
/obj/effect/turf_decal/siding/wood{
	dir = 1
	},
/obj/effect/turf_decal/siding/wood/corner{
	dir = 8
	},
/turf/open/floor/wood/tile,
/area/misc/condo)
"aH" = (
/obj/machinery/light/directional/north,
/obj/structure/flora/bush/large/style_random,
/turf/open/floor/grass,
/area/misc/condo)
"aI" = (
/obj/machinery/vending/games{
	shut_up = 1
	},
/obj/effect/turf_decal/siding/wood{
	dir = 5
	},
/turf/open/floor/wood/tile,
/area/misc/condo)
"aJ" = (
/obj/structure/closet/cabinet{
	anchored = 1
	},
/turf/open/floor/carpet/purple,
/area/misc/condo)
"aK" = (
/obj/structure/table/wood/fancy,
/obj/item/toy/plush/beeplushie,
/turf/open/floor/carpet/purple,
/area/misc/condo)
"aV" = (
/obj/machinery/vending/snack/orange{
	shut_up = 1
	},
/obj/effect/turf_decal/siding/wood{
	dir = 4
	},
/turf/open/floor/wood/tile,
/area/misc/condo)
"aW" = (
/obj/machinery/light/directional/west,
/obj/structure/dresser,
/turf/open/floor/carpet/purple,
/area/misc/condo)
"aX" = (
/obj/structure/bed/double,
/obj/machinery/light/directional/east,
/obj/effect/spawner/random/bedsheet/double,
/turf/open/floor/carpet/purple,
/area/misc/condo)
"ba" = (
/turf/open/indestructible/hoteltile,
/area/misc/condo)
"bb" = (
/obj/structure/mineral_door/paperframe,
/turf/open/indestructible/hoteltile,
/area/misc/condo)
"bd" = (
/obj/effect/turf_decal/siding/wood{
	dir = 8
	},
/obj/effect/turf_decal/siding/wood{
	dir = 4
	},
/obj/machinery/light/directional/west,
/turf/open/floor/wood/tile,
/area/misc/condo)
"be" = (
/obj/structure/chair/sofa/left/maroon{
	dir = 4
	},
/turf/open/floor/carpet,
/area/misc/condo)
"bg" = (
/obj/structure/table/wood,
/obj/item/pizzabox/margherita{
	pixel_y = 11
	},
/turf/open/floor/carpet,
/area/misc/condo)
"bh" = (
/obj/structure/chair/sofa/right/maroon{
	dir = 8
	},
/turf/open/floor/carpet,
/area/misc/condo)
"bi" = (
/obj/machinery/light/directional/east,
/obj/machinery/jukebox{
	req_one_access = null;
	area_limited = 1
	},
/obj/effect/turf_decal/siding/wood{
	dir = 4
	},
/turf/open/floor/wood/tile,
/area/misc/condo)
"bj" = (
/obj/machinery/computer{
	dir = 4
	},
/obj/item/choice_beacon/box/plushie,
/turf/open/floor/carpet/purple,
/area/misc/condo)
"bk" = (
/obj/structure/fake_stairs/directional/west,
/turf/open/floor/iron/cafeteria,
/area/misc/condo)
"bl" = (
/obj/structure/table/wood/fancy,
/obj/machinery/light_switch/directional/east,
/obj/item/flashlight/lamp/green{
	pixel_x = 4;
	pixel_y = 9
	},
/turf/open/floor/carpet/purple,
/area/misc/condo)
"br" = (
/obj/structure/chair/sofa/middle/maroon{
	dir = 4
	},
/turf/open/floor/carpet,
/area/misc/condo)
"bs" = (
/obj/structure/table/wood,
/obj/item/toy/cards/deck,
/obj/item/flashlight/flare/candle/vanilla,
/turf/open/floor/carpet,
/area/misc/condo)
"bt" = (
/obj/structure/table/wood,
/obj/item/flashlight/flare/candle/vanilla,
/turf/open/floor/carpet,
/area/misc/condo)
"bu" = (
/obj/structure/chair/sofa/middle/maroon{
	dir = 8
	},
/turf/open/floor/carpet,
/area/misc/condo)
"bA" = (
/obj/structure/chair/sofa/right/maroon{
	dir = 4
	},
/turf/open/floor/carpet,
/area/misc/condo)
"bB" = (
/obj/structure/table/wood,
/turf/open/floor/carpet,
/area/misc/condo)
"bD" = (
/obj/structure/chair/sofa/left/maroon{
	dir = 8
	},
/turf/open/floor/carpet,
/area/misc/condo)
"bG" = (
/obj/structure/mineral_door/wood,
/turf/open/floor/wood/tile,
/area/misc/condo)
"bH" = (
/obj/effect/turf_decal/siding/wood{
	dir = 1
	},
/turf/open/floor/wood/tile,
/area/misc/condo)
"bJ" = (
/obj/effect/turf_decal/siding/wood{
	dir = 1
	},
/obj/structure/sign/poster/contraband/random/directional/east,
/turf/open/floor/wood/tile,
/area/misc/condo)
"bK" = (
/turf/open/floor/iron/cafeteria,
/area/misc/condo)
"bP" = (
/obj/structure/fake_stairs/directional/south,
/turf/open/floor/wood/tile,
/area/misc/condo)
"bQ" = (
/obj/machinery/light/directional/east,
/obj/structure/fake_stairs/directional/south,
/turf/open/floor/wood/tile,
/area/misc/condo)
"bZ" = (
/obj/structure/railing,
/obj/effect/spawner/liquids_spawner/ankles,
/turf/open/floor/iron/pool,
/area/misc/condo)
"cb" = (
/obj/structure/chair/stool/bar,
/obj/effect/turf_decal/siding/wood{
	dir = 10
	},
/obj/effect/turf_decal/siding/wood/corner{
	dir = 4
	},
/turf/open/floor/wood/tile,
/area/misc/condo)
"cc" = (
/obj/structure/closet/crate/bin,
/obj/effect/turf_decal/siding/wood,
/obj/effect/turf_decal/siding/wood{
	dir = 1
	},
/turf/open/floor/wood/tile,
/area/misc/condo)
"cd" = (
/obj/structure/stripper_pole,
/turf/open/floor/light,
/area/misc/condo)
"cg" = (
/obj/structure/table/reinforced,
/obj/item/reagent_containers/cup/glass{
	pixel_y = 4;
	pixel_x = -4
	},
/obj/item/reagent_containers/cup/glass{
	pixel_y = 5;
	pixel_x = 6
	},
/obj/item/reagent_containers/cup/glass,
/obj/item/reagent_containers/cup/glass/bottle/champagne{
	pixel_y = 9;
	pixel_x = 10
	},
/turf/open/floor/iron/cafeteria,
/area/misc/condo)
"ch" = (
/obj/structure/table/reinforced,
/turf/open/floor/iron/cafeteria,
/area/misc/condo)
"ci" = (
/obj/structure/table/reinforced,
/obj/effect/spawner/random/food_or_drink/three_course_meal,
/turf/open/floor/iron/cafeteria,
/area/misc/condo)
"cj" = (
/obj/structure/railing{
	dir = 1;
	icon_state = "railing"
	},
/turf/open/floor/carpet,
/area/misc/condo)
"cl" = (
/obj/structure/table/reinforced,
/obj/machinery/microwave,
/turf/open/floor/iron/cafeteria,
/area/misc/condo)
"cq" = (
/obj/structure/fake_stairs/directional/north,
/turf/open/floor/wood/tile,
/area/misc/condo)
"cr" = (
/obj/structure/fake_stairs/directional/east,
/turf/open/floor/wood/tile,
/area/misc/condo)
"cs" = (
/obj/machinery/light/small/directional/north,
/turf/open/indestructible/hoteltile,
/area/misc/condo)
"ct" = (
/obj/structure/window/reinforced/tinted/spawner/directional/east,
/turf/open/indestructible/hoteltile,
/area/misc/condo)
"cu" = (
/obj/machinery/light/small/directional/north,
/obj/effect/spawner/liquids_spawner/ankles,
/turf/open/floor/iron/pool,
/area/misc/condo)
"cv" = (
/obj/machinery/shower/directional/west,
/obj/effect/spawner/liquids_spawner/ankles,
/turf/open/floor/iron/pool,
/area/misc/condo)
"cw" = (
/obj/structure/sink/kitchen/directional/east,
/turf/open/floor/iron/cafeteria,
/area/misc/condo)
"cy" = (
/obj/structure/mirror{
	pixel_x = -32
	},
/obj/structure/sink/kitchen/directional/east,
/obj/structure/window/reinforced/tinted/spawner/directional/south,
/turf/open/indestructible/hoteltile,
/area/misc/condo)
"cz" = (
/obj/structure/closet/secure_closet/freezer/fridge/all_access,
/turf/open/floor/iron/cafeteria,
/area/misc/condo)
"cB" = (
/obj/structure/toilet{
	dir = 4
	},
/turf/open/indestructible/hoteltile,
/area/misc/condo)
"cF" = (
/turf/closed/indestructible/hoteldoor{
	icon_state = "door_closed";
	icon = 'icons/obj/doors/puzzledoor/default.dmi'
	},
/area/misc/condo)
"dk" = (
/obj/structure/bookcase/random/adult,
/turf/open/floor/wood/tile,
/area/misc/condo)
"ep" = (
/obj/effect/turf_decal/siding/wood{
	dir = 9
	},
/obj/structure/railing{
	dir = 8
	},
/turf/open/floor/wood/tile,
/area/misc/condo)
"gq" = (
/obj/structure/table/wood,
/obj/item/storage/fancy/heart_box,
/turf/open/floor/carpet,
/area/misc/condo)
"jn" = (
/turf/closed/wall,
/area/misc/condo)
"kU" = (
/obj/machinery/airalarm/directional/west,
/turf/open/floor/iron/cafeteria,
/area/misc/condo)
"lG" = (
/obj/structure/bed/dogbed,
/turf/open/floor/carpet/purple,
/area/misc/condo)
"mh" = (
/obj/structure/flora/bush/grassy/style_random,
/obj/structure/flora/bush/generic/style_random,
/obj/structure/flora/bush/leafy,
/obj/structure/flora/bush/jungle/a/style_random,
/turf/open/floor/grass,
/area/misc/condo)
"no" = (
/obj/structure/flora/bush/lavendergrass/style_random,
/obj/structure/flora/bush/grassy/style_random,
/obj/structure/flora/bush/generic/style_random,
/obj/structure/flora/bush/leafy,
/obj/structure/flora/bush/jungle/c/style_random,
/turf/open/floor/grass,
/area/misc/condo)
"uG" = (
/obj/structure/table,
/obj/structure/towel_bin,
/turf/open/indestructible/hoteltile,
/area/misc/condo)
"CV" = (
/obj/structure/railing/corner,
/obj/effect/spawner/liquids_spawner/ankles,
/turf/open/floor/iron/pool,
/area/misc/condo)
"Fk" = (
/turf/open/floor/wood/tile,
/area/misc/condo)
"Ge" = (
/obj/structure/flora/bush/lavendergrass/style_random,
/obj/structure/flora/bush/grassy/style_random,
/obj/structure/flora/bush/large/style_random,
/turf/open/floor/grass,
/area/misc/condo)
"GR" = (
/obj/machinery/room_controller/directional/south,
/turf/open/floor/iron/cafeteria,
/area/misc/condo)
"IT" = (
/turf/open/floor/carpet/purple,
/area/misc/condo)
"Kv" = (
/obj/machinery/light_switch/directional/east{
	pixel_x = 22
	},
/turf/open/floor/iron/cafeteria,
/area/misc/condo)
"MA" = (
/obj/structure/sign/poster/contraband/random,
/turf/closed/indestructible/steel,
/area/misc/condo)
"Oe" = (
/obj/machinery/smartfridge/food,
/turf/open/floor/iron/cafeteria,
/area/misc/condo)
"Os" = (
/obj/effect/turf_decal/siding/wood/corner{
	dir = 1
	},
/turf/open/floor/wood/tile,
/area/misc/condo)
"TU" = (
/obj/effect/turf_decal/siding/wood/corner{
	dir = 4
	},
/obj/machinery/light_switch/directional/south,
/turf/open/floor/wood/tile,
/area/misc/condo)
"VG" = (
/obj/effect/turf_decal/siding/wood{
	dir = 9
	},
/obj/effect/turf_decal/siding/wood{
	dir = 4
	},
/turf/open/floor/wood/tile,
/area/misc/condo)
"WN" = (
/obj/structure/chair/stool/bar,
/obj/effect/turf_decal/siding/wood,
/obj/effect/turf_decal/siding/wood{
	dir = 1
	},
/turf/open/floor/wood/tile,
/area/misc/condo)
"Xu" = (
/obj/effect/turf_decal/siding/wood{
	dir = 8
	},
/turf/open/floor/wood/tile,
/area/misc/condo)
"Zh" = (
/obj/effect/turf_decal/siding/wood{
	dir = 8
	},
/obj/effect/turf_decal/siding/wood{
	dir = 4
	},
/turf/open/floor/wood/tile,
/area/misc/condo)
"Zy" = (
/obj/machinery/vending/boozeomat{
	shut_up = 1
	},
/turf/closed/indestructible/steel,
/area/misc/condo)

(1,1,1) = {"
ab
ab
ab
ab
ab
ab
ab
ab
ab
ab
ab
ab
ab
ab
ab
ab
"}
(2,1,1) = {"
ab
ai
ah
ah
ah
MA
ah
ah
ah
ah
ah
ah
Zy
ah
ah
ab
"}
(3,1,1) = {"
ab
ab
ah
dk
VG
bd
Zh
Zh
Zh
cb
cg
cw
bK
ch
ah
ab
"}
(4,1,1) = {"
ab
ab
ah
Ge
cj
be
br
bA
aD
WN
ch
bK
bK
cl
ah
ab
"}
(5,1,1) = {"
ab
ab
ah
no
cj
gq
bs
bB
aD
WN
ci
bK
bK
cz
ah
ab
"}
(6,1,1) = {"
ab
ab
ah
aH
cj
bg
bt
bB
aD
cc
Oe
bk
jn
jn
ah
ab
"}
(7,1,1) = {"
ab
ab
ah
mh
cj
bh
bu
bD
aD
aF
cq
bK
kU
bK
cF
ab
"}
(8,1,1) = {"
ab
ab
ah
ep
Xu
Xu
Xu
Xu
Xu
Os
cq
bK
Kv
GR
ah
ab
"}
(9,1,1) = {"
ab
ab
ah
aI
aV
bi
aE
TU
jn
jn
jn
bb
jn
jn
ah
ab
"}
(10,1,1) = {"
ab
ab
ah
jn
jn
jn
jn
cr
jn
ao
jn
ba
cy
cB
ah
ab
"}
(11,1,1) = {"
ab
ab
ah
aJ
aW
bj
jn
bG
jn
ap
jn
cs
ba
ba
ah
ab
"}
(12,1,1) = {"
ab
ab
ah
IT
IT
IT
IT
bH
bP
Fk
jn
ct
ct
ba
ah
ab
"}
(13,1,1) = {"
ab
ab
ah
lG
IT
IT
IT
bH
bP
cd
jn
cu
CV
ba
ah
ab
"}
(14,1,1) = {"
ab
ab
ah
aK
aX
bl
IT
bJ
bQ
Fk
jn
cv
bZ
uG
ah
ab
"}
(15,1,1) = {"
ab
ab
ah
ah
ah
ah
ah
ah
ah
ah
ah
ah
ah
ah
ah
ab
"}
(16,1,1) = {"
ab
ab
ab
ab
ab
ab
ab
ab
ab
ab
ab
ab
ab
ab
ab
ab
"}
