//MAP CONVERTED BY dmm2tgm.py THIS HEADER COMMENT PREVENTS RECONVERSION, DO NOT REMOVE
"an" = (
/obj/effect/decal/cleanable/dirt/dust,
/obj/machinery/atmospherics/pipe/smart/manifold/scrubbers/hidden/layer4,
/turf/open/floor/iron/dark/smooth_large,
/area/misc/hilbertshotel)
"au" = (
/obj/machinery/door/firedoor,
/obj/machinery/door/airlock/command/glass,
/obj/effect/mapping_helpers/airlock/abandoned,
/obj/machinery/atmospherics/pipe/smart/manifold/supply/hidden/layer2,
/obj/machinery/atmospherics/pipe/smart/manifold/scrubbers/hidden/layer4,
/obj/structure/cable,
/turf/open/floor/iron/dark,
/area/misc/hilbertshotel)
"bm" = (
/obj/machinery/status_display/random_message/directional/north,
/obj/effect/decal/cleanable/dirt/dust,
/turf/open/floor/iron/dark/smooth_corner,
/area/misc/hilbertshotel)
"bB" = (
/obj/machinery/portable_atmospherics/scrubber,
/turf/open/floor/plating,
/area/misc/hilbertshotel)
"bD" = (
/obj/effect/mapping_helpers/broken_floor,
/obj/machinery/light/broken/directional/south,
/turf/open/floor/plating,
/area/misc/hilbertshotel)
"cV" = (
/obj/structure/girder/displaced,
/turf/open/floor/iron/dark/smooth_large,
/area/misc/hilbertshotel)
"de" = (
/obj/effect/mapping_helpers/broken_floor,
/obj/structure/frame/computer{
	dir = 8
	},
/turf/open/floor/plating,
/area/misc/hilbertshotel)
"dx" = (
/obj/machinery/light/small/directional/west,
/obj/effect/decal/cleanable/dirt/dust,
/obj/machinery/room_controller/directional/south,
/turf/open/floor/iron/dark/smooth_corner{
	dir = 4
	},
/area/misc/hilbertshotel)
"dI" = (
/obj/effect/decal/cleanable/blood/old,
/turf/open/floor/plating,
/area/misc/hilbertshotel)
"ea" = (
/obj/machinery/door/firedoor,
/obj/effect/mapping_helpers/broken_floor,
/turf/open/floor/plating,
/area/misc/hilbertshotel)
"ed" = (
/obj/effect/decal/cleanable/blood/old,
/obj/effect/mapping_helpers/broken_floor,
/turf/open/floor/iron/dark,
/area/misc/hilbertshotel)
"eI" = (
/obj/machinery/atmospherics/components/unary/vent_scrubber/on/layer4,
/turf/open/floor/iron/dark,
/area/misc/hilbertshotel)
"fa" = (
/obj/machinery/atmospherics/components/unary/vent_pump/on/layer2,
/turf/open/floor/iron/dark,
/area/misc/hilbertshotel)
"ii" = (
/obj/effect/decal/cleanable/glass,
/obj/structure/grille/broken,
/turf/open/floor/plating/foam,
/area/misc/hilbertshotel)
"jh" = (
/turf/open/indestructible/dark/textured{
	icon = 'modular_zubbers/icons/space/space.dmi';
	icon_state = "space";
	name = "space"
	},
/area/misc/hilbertshotel)
"jC" = (
/turf/open/floor/plating,
/area/misc/hilbertshotel)
"jK" = (
/obj/structure/grille/broken,
/obj/effect/decal/cleanable/glass,
/obj/effect/mapping_helpers/broken_floor,
/turf/open/floor/plating,
/area/misc/hilbertshotel)
"jU" = (
/obj/effect/decal/cleanable/dirt/dust,
/obj/item/paper/crumpled/bloody{
	default_raw_text = "<B>ATTENTION!</B><BR><BR>Hey there! I hope you two can read english when you crawl out of your ice beds. Your ship is kind of buried nose-deep in an asteroid tumbling through wild space right now, but DO NOT worry! I'll be back with rescue soon enough!<BR><BR>-Signed, A Concerned Space Farer, 2553"
	},
/obj/machinery/atmospherics/pipe/smart/manifold/supply/hidden/layer2,
/obj/machinery/atmospherics/pipe/smart/manifold/scrubbers/hidden/layer4,
/obj/structure/cable,
/turf/open/floor/iron/dark/smooth_half{
	dir = 1
	},
/area/misc/hilbertshotel)
"kx" = (
/turf/closed/mineral,
/area/misc/hilbertshotel)
"kE" = (
/turf/closed/wall/r_wall,
/area/misc/hilbertshotel)
"lS" = (
/obj/effect/decal/cleanable/glass,
/obj/structure/grille/broken,
/turf/open/floor/iron/dark/smooth_half,
/area/misc/hilbertshotel)
"mM" = (
/obj/machinery/atmospherics/components/unary/vent_pump/on/layer2,
/turf/open/floor/iron/dark/smooth_large,
/area/misc/hilbertshotel)
"nm" = (
/obj/effect/mapping_helpers/broken_floor,
/obj/machinery/atmospherics/pipe/smart/manifold/supply/hidden/layer2,
/obj/machinery/atmospherics/pipe/smart/manifold/scrubbers/hidden/layer4,
/obj/structure/cable,
/turf/open/floor/iron/dark,
/area/misc/hilbertshotel)
"np" = (
/obj/item/crowbar/large,
/obj/effect/decal/cleanable/dirt/dust,
/obj/machinery/atmospherics/components/unary/vent_pump/on/layer2,
/obj/machinery/atmospherics/pipe/smart/manifold/scrubbers/hidden/layer4,
/turf/open/floor/iron/dark/smooth_half{
	dir = 1
	},
/area/misc/hilbertshotel)
"nO" = (
/turf/open/floor/iron/dark,
/area/misc/hilbertshotel)
"nU" = (
/obj/effect/decal/cleanable/glass,
/turf/open/floor/plating,
/area/misc/hilbertshotel)
"pp" = (
/obj/item/light/tube/broken,
/obj/effect/decal/cleanable/dirt/dust,
/obj/machinery/firealarm/directional/north,
/turf/open/floor/iron/dark/smooth_half,
/area/misc/hilbertshotel)
"qq" = (
/obj/effect/spawner/structure/window/reinforced/indestructible,
/obj/effect/mapping_helpers/broken_machine,
/turf/open/floor/plating/foam,
/area/misc/hilbertshotel)
"rj" = (
/obj/machinery/atmospherics/pipe/smart/manifold/supply/hidden/layer2,
/obj/machinery/atmospherics/pipe/smart/manifold/scrubbers/hidden/layer4,
/obj/structure/cable,
/turf/open/floor/plating,
/area/misc/hilbertshotel)
"sf" = (
/obj/machinery/atmospherics/pipe/smart/manifold/supply/hidden/layer2,
/obj/machinery/atmospherics/pipe/smart/manifold/scrubbers/hidden/layer4,
/obj/structure/cable,
/turf/open/floor/iron/dark/smooth_large,
/area/misc/hilbertshotel)
"sn" = (
/obj/effect/decal/cleanable/dirt,
/obj/machinery/atmospherics/pipe/smart/manifold/supply/hidden/layer2,
/obj/machinery/atmospherics/pipe/smart/manifold/scrubbers/hidden/layer4,
/obj/structure/cable,
/turf/open/floor/iron/dark,
/area/misc/hilbertshotel)
"sL" = (
/obj/structure/girder/displaced,
/obj/effect/mapping_helpers/broken_floor,
/turf/open/floor/plating,
/area/misc/hilbertshotel)
"tC" = (
/obj/structure/girder,
/turf/open/floor/plating,
/area/misc/hilbertshotel)
"tN" = (
/obj/machinery/atmospherics/pipe/smart/manifold/scrubbers/hidden/layer4,
/obj/machinery/atmospherics/pipe/smart/manifold/supply/hidden/layer2,
/obj/structure/cable,
/turf/open/floor/iron/dark,
/area/misc/hilbertshotel)
"tQ" = (
/turf/closed/indestructible/steel,
/area/misc/hilbertshotel)
"tS" = (
/turf/closed/indestructible/fakedoor/maintenance,
/area/misc/hilbertshotel)
"uB" = (
/turf/open/floor/iron/dark/smooth_large,
/area/misc/hilbertshotel)
"vs" = (
/obj/machinery/light/red/dim/directional/south,
/obj/machinery/atmospherics/pipe/smart/manifold/supply/hidden/layer2,
/obj/machinery/atmospherics/pipe/smart/manifold/scrubbers/hidden/layer4,
/obj/structure/cable,
/turf/open/floor/iron/dark/smooth_half,
/area/misc/hilbertshotel)
"vu" = (
/obj/machinery/suit_storage_unit{
	access_locked = 1
	},
/obj/effect/mapping_helpers/broken_machine,
/turf/open/floor/iron/dark/smooth_corner,
/area/misc/hilbertshotel)
"vS" = (
/obj/machinery/atmospherics/pipe/smart/manifold/supply/hidden/layer2,
/obj/machinery/atmospherics/pipe/smart/manifold/scrubbers/hidden/layer4,
/obj/structure/cable,
/turf/open/floor/iron/dark,
/area/misc/hilbertshotel)
"vX" = (
/obj/effect/mapping_helpers/broken_floor,
/obj/machinery/atmospherics/pipe/smart/manifold/supply/hidden/layer2,
/obj/machinery/atmospherics/pipe/smart/manifold/scrubbers/hidden/layer4,
/obj/structure/cable,
/turf/open/floor/iron/dark/smooth_large,
/area/misc/hilbertshotel)
"wh" = (
/obj/structure/fireaxecabinet,
/turf/closed/wall/r_wall,
/area/misc/hilbertshotel)
"wp" = (
/obj/effect/decal/cleanable/dirt,
/obj/machinery/suit_storage_unit{
	access_locked = 1
	},
/obj/effect/mapping_helpers/broken_machine,
/turf/open/floor/iron/dark/smooth_corner{
	dir = 4
	},
/area/misc/hilbertshotel)
"wt" = (
/turf/closed/indestructible/fakedoor/engineering,
/area/misc/hilbertshotel)
"wH" = (
/obj/structure/closet,
/turf/open/floor/iron/dark,
/area/misc/hilbertshotel)
"wX" = (
/obj/effect/decal/cleanable/dirt,
/obj/machinery/atmospherics/pipe/smart/manifold/supply/hidden/layer2,
/obj/machinery/atmospherics/pipe/smart/manifold/scrubbers/hidden/layer4,
/obj/structure/cable,
/turf/open/floor/plating,
/area/misc/hilbertshotel)
"yj" = (
/obj/machinery/atmospherics/pipe/smart/manifold/scrubbers/hidden/layer4,
/obj/machinery/atmospherics/pipe/smart/manifold/supply/hidden/layer2,
/obj/structure/cable,
/turf/open/floor/plating,
/area/misc/hilbertshotel)
"yu" = (
/obj/effect/decal/cleanable/glass,
/turf/open/floor/plating/foam,
/area/misc/hilbertshotel)
"yN" = (
/obj/effect/mapping_helpers/broken_floor,
/obj/effect/decal/cleanable/glass,
/obj/machinery/light/small/broken/directional/south,
/turf/open/floor/plating,
/area/misc/hilbertshotel)
"zs" = (
/obj/item/light/tube/broken,
/obj/effect/decal/cleanable/dirt/dust,
/turf/open/floor/iron/dark,
/area/misc/hilbertshotel)
"Ae" = (
/obj/structure/fluff/broken_canister_frame,
/turf/open/floor/iron/dark/smooth_half{
	dir = 1
	},
/area/misc/hilbertshotel)
"As" = (
/obj/structure/table/wood,
/turf/open/floor/plating,
/area/misc/hilbertshotel)
"Bs" = (
/obj/effect/decal/cleanable/dirt,
/turf/open/floor/iron/dark/smooth_large,
/area/misc/hilbertshotel)
"CK" = (
/obj/effect/spawner/structure/window/reinforced/indestructible,
/obj/effect/mapping_helpers/broken_machine,
/turf/open/floor/plating,
/area/misc/hilbertshotel)
"CQ" = (
/obj/effect/mapping_helpers/broken_machine,
/turf/closed/wall/r_wall,
/area/misc/hilbertshotel)
"DO" = (
/obj/effect/decal/cleanable/glass,
/obj/item/light/tube/broken,
/turf/open/floor/iron/dark/smooth_large,
/area/misc/hilbertshotel)
"DR" = (
/obj/machinery/computer/old{
	dir = 1;
	name = "Cryostasis Monitor"
	},
/obj/effect/decal/cleanable/dirt/dust,
/turf/open/floor/iron/dark/smooth_half{
	dir = 1
	},
/area/misc/hilbertshotel)
"Eh" = (
/obj/machinery/door/airlock/colony_prefab,
/obj/effect/mapping_helpers/airlock/abandoned,
/turf/open/floor/iron/dark,
/area/misc/hilbertshotel)
"EO" = (
/obj/machinery/door/airlock/survival_pod,
/obj/effect/mapping_helpers/airlock/abandoned,
/obj/machinery/atmospherics/pipe/smart/manifold/supply/hidden/layer2,
/obj/machinery/atmospherics/pipe/smart/manifold/scrubbers/hidden/layer4,
/obj/structure/cable,
/turf/open/floor/iron/dark,
/area/misc/hilbertshotel)
"Gp" = (
/obj/machinery/door/airlock/maintenance_hatch,
/obj/machinery/atmospherics/pipe/smart/manifold/supply/hidden/layer2,
/obj/machinery/atmospherics/pipe/smart/manifold/scrubbers/hidden/layer4,
/obj/structure/cable,
/turf/open/space/basic,
/area/misc/hilbertshotel)
"Hb" = (
/obj/effect/decal/cleanable/dirt/dust,
/obj/machinery/light/red/dim/directional/south,
/obj/structure/cable,
/turf/open/floor/iron/dark/smooth_corner{
	dir = 1
	},
/area/misc/hilbertshotel)
"HO" = (
/obj/effect/mapping_helpers/broken_floor,
/obj/machinery/light/broken/directional/north,
/turf/open/floor/iron/dark/smooth_half,
/area/misc/hilbertshotel)
"IY" = (
/obj/item/flashlight/flare,
/obj/structure/cable,
/obj/machinery/vending/dorms{
	density = 0;
	pixel_y = -32
	},
/turf/open/floor/iron/dark/smooth_half,
/area/misc/hilbertshotel)
"Jn" = (
/obj/effect/spawner/structure/window/reinforced/indestructible,
/turf/open/floor/plating,
/area/misc/hilbertshotel)
"Kz" = (
/obj/machinery/light/red/dim/directional/west,
/obj/machinery/atmospherics/pipe/smart/manifold/supply/hidden/layer2,
/obj/machinery/atmospherics/pipe/smart/manifold/scrubbers/hidden/layer4,
/obj/structure/cable,
/turf/open/floor/plating,
/area/misc/hilbertshotel)
"LT" = (
/turf/open/floor/iron/dark/smooth_half,
/area/misc/hilbertshotel)
"LZ" = (
/obj/effect/decal/cleanable/dirt/dust,
/turf/open/floor/iron/dark/smooth_large,
/area/misc/hilbertshotel)
"Mc" = (
/obj/machinery/door/firedoor,
/turf/open/floor/iron/dark,
/area/misc/hilbertshotel)
"MK" = (
/obj/effect/decal/cleanable/dirt/dust,
/obj/machinery/atmospherics/components/unary/vent_scrubber/on/layer4,
/turf/open/floor/iron/dark/smooth_corner{
	dir = 8
	},
/area/misc/hilbertshotel)
"Nl" = (
/obj/machinery/atmospherics/pipe/smart/manifold/supply/hidden/layer2,
/obj/machinery/atmospherics/pipe/smart/manifold/scrubbers/hidden/layer4,
/obj/structure/cable,
/turf/closed/indestructible/fakedoor/glass_airlock,
/area/misc/hilbertshotel)
"Ny" = (
/obj/effect/decal/cleanable/dirt/dust,
/obj/machinery/computer/old{
	name = "Cryostasis Monitor"
	},
/turf/open/floor/iron/dark/smooth_half{
	dir = 1
	},
/area/misc/hilbertshotel)
"NE" = (
/obj/machinery/atmospherics/pipe/smart/manifold/scrubbers/hidden/layer4,
/obj/machinery/atmospherics/pipe/smart/manifold/supply/hidden/layer2,
/obj/structure/cable,
/turf/closed/indestructible/steel,
/area/misc/hilbertshotel)
"NG" = (
/obj/machinery/door/airlock/maintenance_hatch,
/obj/effect/mapping_helpers/airlock/abandoned,
/obj/machinery/atmospherics/pipe/smart/manifold/supply/hidden/layer2,
/obj/machinery/atmospherics/pipe/smart/manifold/scrubbers/hidden/layer4,
/obj/structure/cable,
/turf/open/floor/iron/dark,
/area/misc/hilbertshotel)
"Or" = (
/obj/machinery/light/small/red/dim,
/turf/open/floor/iron/dark,
/area/misc/hilbertshotel)
"OJ" = (
/obj/item/light/tube/broken,
/obj/machinery/atmospherics/pipe/smart/manifold/supply/hidden/layer2,
/obj/machinery/atmospherics/pipe/smart/manifold/scrubbers/hidden/layer4,
/obj/structure/cable,
/turf/open/floor/iron/dark,
/area/misc/hilbertshotel)
"OV" = (
/obj/effect/decal/cleanable/glass,
/obj/effect/mapping_helpers/broken_floor,
/turf/open/floor/iron/dark,
/area/misc/hilbertshotel)
"Pi" = (
/obj/effect/mapping_helpers/broken_floor,
/obj/effect/decal/cleanable/glass,
/turf/open/floor/plating,
/area/misc/hilbertshotel)
"PA" = (
/obj/machinery/computer/old{
	name = "Malfunctioning Navigation Terminal";
	dir = 8
	},
/turf/open/floor/plating/foam,
/area/misc/hilbertshotel)
"PR" = (
/obj/structure/firelock_frame,
/obj/machinery/atmospherics/pipe/smart/manifold/supply/hidden/layer2,
/obj/machinery/atmospherics/pipe/smart/manifold/scrubbers/hidden/layer4,
/obj/structure/cable,
/turf/open/floor/iron/dark,
/area/misc/hilbertshotel)
"QN" = (
/obj/machinery/door/airlock/colony_prefab,
/obj/effect/mapping_helpers/airlock/abandoned,
/obj/machinery/atmospherics/pipe/smart/manifold/supply/hidden/layer2,
/obj/machinery/atmospherics/pipe/smart/manifold/scrubbers/hidden/layer4,
/obj/structure/cable,
/turf/open/floor/iron/dark,
/area/misc/hilbertshotel)
"Rv" = (
/obj/effect/decal/cleanable/dirt,
/turf/open/floor/iron/dark,
/area/misc/hilbertshotel)
"RZ" = (
/obj/effect/decal/cleanable/dirt/dust,
/obj/machinery/atmospherics/pipe/smart/manifold/supply/hidden/layer2,
/obj/machinery/atmospherics/pipe/smart/manifold/scrubbers/hidden/layer4,
/obj/structure/cable,
/turf/open/floor/iron/dark,
/area/misc/hilbertshotel)
"Sg" = (
/obj/effect/mapping_helpers/broken_floor,
/turf/open/floor/iron/dark,
/area/misc/hilbertshotel)
"Sh" = (
/obj/machinery/light/red/dim/directional/north,
/turf/open/floor/iron/dark/smooth_half,
/area/misc/hilbertshotel)
"Tm" = (
/obj/machinery/power/smes,
/obj/effect/mapping_helpers/broken_machine,
/turf/open/floor/plating,
/area/misc/hilbertshotel)
"Tn" = (
/obj/machinery/atmospherics/components/unary/vent_scrubber/on/layer4,
/turf/open/floor/iron/dark/smooth_large,
/area/misc/hilbertshotel)
"Tv" = (
/obj/machinery/light/red/dim/directional/north,
/turf/open/floor/iron/dark,
/area/misc/hilbertshotel)
"TH" = (
/obj/effect/decal/cleanable/blood/old,
/turf/open/floor/iron/dark,
/area/misc/hilbertshotel)
"UA" = (
/turf/closed/indestructible/fakedoor/glass_airlock,
/area/misc/hilbertshotel)
"UE" = (
/turf/open/floor/iron/dark/smooth_half{
	dir = 1
	},
/area/misc/hilbertshotel)
"Vk" = (
/obj/effect/decal/cleanable/dirt/dust,
/turf/open/floor/plating,
/area/misc/hilbertshotel)
"Vz" = (
/obj/structure/girder/displaced,
/turf/open/floor/plating,
/area/misc/hilbertshotel)
"Wd" = (
/obj/machinery/light/red/dim/directional/north,
/obj/machinery/atmospherics/pipe/smart/manifold/supply/hidden/layer2,
/obj/machinery/atmospherics/pipe/smart/manifold/scrubbers/hidden/layer4,
/obj/structure/cable,
/turf/open/floor/plating,
/area/misc/hilbertshotel)
"Wk" = (
/obj/machinery/atmospherics/pipe/smart/manifold/supply/hidden/layer2,
/obj/machinery/atmospherics/pipe/smart/manifold/scrubbers/hidden/layer4,
/obj/structure/cable,
/turf/open/floor/iron/dark/smooth_half,
/area/misc/hilbertshotel)
"Wn" = (
/obj/effect/mapping_helpers/broken_floor,
/turf/open/floor/plating,
/area/misc/hilbertshotel)
"Wp" = (
/obj/structure/showcase/machinery/oldpod{
	dir = 4
	},
/obj/effect/mapping_helpers/broken_machine,
/obj/effect/decal/cleanable/dirt/dust,
/turf/open/floor/iron/dark,
/area/misc/hilbertshotel)
"WH" = (
/obj/machinery/light/broken/directional/east,
/turf/open/floor/plating,
/area/misc/hilbertshotel)
"Xr" = (
/obj/structure/grille,
/turf/open/space/basic,
/area/misc/hilbertshotel)
"YS" = (
/obj/effect/mapping_helpers/broken_machine,
/obj/structure/showcase/machinery/oldpod{
	dir = 4
	},
/obj/effect/decal/cleanable/dirt/dust,
/turf/open/floor/iron/dark,
/area/misc/hilbertshotel)
"YZ" = (
/obj/machinery/atmospherics/pipe/smart/manifold/scrubbers/hidden/layer4,
/turf/open/floor/iron/dark/smooth_large,
/area/misc/hilbertshotel)
"ZV" = (
/obj/structure/closet,
/turf/open/floor/plating,
/area/misc/hilbertshotel)

(1,1,1) = {"
tQ
tQ
NE
tQ
kE
kE
kE
kE
kE
kE
UA
UA
kE
kx
kx
"}
(2,1,1) = {"
tQ
Tm
tN
ZV
CQ
bm
DR
Ny
dx
kE
nO
vS
CK
jh
kx
"}
(3,1,1) = {"
tQ
yj
yj
wH
kE
pp
YS
Wp
IY
kE
Tv
sn
CK
kx
kx
"}
(4,1,1) = {"
tQ
rj
As
bB
wh
MK
np
jU
Hb
kE
TH
nm
Jn
jh
kx
"}
(5,1,1) = {"
tQ
Gp
tQ
tQ
kE
kE
kE
EO
kE
kE
fa
vS
Jn
jh
kx
"}
(6,1,1) = {"
UA
vS
vS
QN
RZ
Kz
nm
RZ
RZ
Nl
sn
OJ
CK
kx
kx
"}
(7,1,1) = {"
UA
vS
Rv
Eh
zs
OV
ed
Sg
WH
Mc
nO
PR
tQ
kx
kx
"}
(8,1,1) = {"
tQ
Gp
tQ
tQ
tC
jK
ea
tC
tQ
tQ
Tv
sn
tQ
tQ
kx
"}
(9,1,1) = {"
tQ
wX
jC
tQ
vu
UE
Ae
UE
wp
tQ
eI
vS
Or
tQ
kx
"}
(10,1,1) = {"
tQ
rj
Vk
tQ
LT
Tn
an
mM
Wk
au
rj
vS
nO
wt
kx
"}
(11,1,1) = {"
tQ
rj
jC
tQ
Sh
Bs
YZ
uB
vs
tQ
jC
nU
yN
tQ
kx
"}
(12,1,1) = {"
tQ
Wd
wX
NG
Wk
sf
sf
vX
Wk
tC
Wn
sL
tC
tQ
kx
"}
(13,1,1) = {"
tQ
jC
nU
tQ
HO
cV
LZ
Wn
bD
tQ
Pi
tC
kx
kx
kx
"}
(14,1,1) = {"
tQ
nU
tC
tQ
de
DO
dI
yu
PA
Vz
Xr
kx
kx
kx
kx
"}
(15,1,1) = {"
tQ
Vz
kx
kx
lS
kx
ii
qq
CK
Vz
kx
kx
kx
kx
kx
"}
(16,1,1) = {"
tQ
tS
kx
kx
kx
kx
kx
kx
kx
kx
kx
kx
kx
kx
kx
"}
