//MAP CONVERTED BY dmm2tgm.py THIS HEADER COMMENT PREVENTS RECONVERSION, DO NOT REMOVE
"af" = (
/turf/open/floor/wood/tile,
/area/misc/condo)
"cK" = (
/turf/open/floor/carpet/black,
/area/misc/condo)
"dy" = (
/obj/structure/chair/stool/bar,
/turf/open/floor/carpet/black,
/area/misc/condo)
"dR" = (
/obj/effect/turf_decal/siding/wood{
	dir = 1
	},
/obj/structure/table/wood/fancy/royalblack,
/obj/item/storage/fancy/heart_box,
/turf/open/floor/wood/tile,
/area/misc/condo)
"ee" = (
/turf/open/floor/carpet/royalblack,
/area/misc/condo)
"fo" = (
/obj/machinery/vending/boozeomat{
	shut_up = 1
	},
/turf/open/floor/wood/tile,
/area/misc/condo)
"hi" = (
/obj/structure/chair/stool/bar{
	dir = 1
	},
/turf/open/floor/carpet/royalblack,
/area/misc/condo)
"jj" = (
/obj/structure/mirror,
/turf/closed/indestructible/steel,
/area/misc/condo)
"kp" = (
/obj/structure/table/wood,
/obj/machinery/light/directional/east,
/obj/structure/sign/poster/random/directional/east,
/turf/open/floor/carpet/royalblack,
/area/misc/condo)
"kr" = (
/obj/effect/turf_decal/siding/wood,
/obj/structure/chair/stool/bar{
	dir = 1
	},
/turf/open/floor/carpet/royalblack,
/area/misc/condo)
"kB" = (
/obj/item/toy/cards/deck,
/obj/structure/table/wood/fancy/purple,
/turf/open/floor/carpet/royalblack,
/area/misc/condo)
"kC" = (
/obj/structure/table/wood,
/obj/machinery/light/directional/east,
/obj/structure/sign/poster/contraband/random/directional/east,
/turf/open/floor/carpet/royalblack,
/area/misc/condo)
"kQ" = (
/turf/closed/indestructible/hoteldoor{
	icon_state = "door_closed";
	icon = 'icons/obj/doors/puzzledoor/default.dmi'
	},
/area/misc/condo)
"li" = (
/obj/structure/table/wood,
/obj/item/reagent_containers/cup/glass/drinkingglass,
/obj/item/reagent_containers/cup/glass/shaker{
	pixel_x = -10;
	pixel_y = 12
	},
/obj/item/reagent_containers/cup/glass/shaker{
	pixel_x = -10
	},
/obj/machinery/light/directional/south,
/turf/open/floor/wood/tile,
/area/misc/condo)
"lS" = (
/obj/structure/table/wood,
/obj/machinery/chem_dispenser/drinks{
	dir = 1
	},
/turf/open/floor/wood/tile,
/area/misc/condo)
"lT" = (
/obj/machinery/light_switch/directional/east,
/turf/open/indestructible/hoteltile,
/area/misc/condo)
"nj" = (
/obj/effect/turf_decal/siding/wood,
/obj/structure/table/wood/fancy/purple,
/turf/open/floor/carpet/royalblack,
/area/misc/condo)
"nQ" = (
/obj/effect/turf_decal/siding/wood{
	dir = 1
	},
/obj/structure/table/wood/fancy/royalblack,
/turf/open/floor/wood/tile,
/area/misc/condo)
"oH" = (
/obj/structure/table/wood,
/obj/machinery/chem_dispenser/drinks/beer{
	dir = 1
	},
/obj/structure/sign/poster/random/directional/south,
/turf/open/floor/wood/tile,
/area/misc/condo)
"pr" = (
/obj/structure/chair/stool/bar,
/turf/open/floor/carpet/royalblack,
/area/misc/condo)
"qn" = (
/obj/machinery/door/window/survival_pod/left/directional/west,
/turf/open/floor/carpet/black,
/area/misc/condo)
"qQ" = (
/obj/structure/table/wood/fancy/purple,
/turf/open/floor/carpet/royalblack,
/area/misc/condo)
"sm" = (
/obj/effect/turf_decal/siding/wood,
/turf/open/floor/carpet/royalblack,
/area/misc/condo)
"sU" = (
/obj/structure/sink/directional/south,
/turf/open/indestructible/hoteltile,
/area/misc/condo)
"sY" = (
/obj/structure/table/wood,
/obj/effect/turf_decal/siding/wood{
	dir = 8
	},
/turf/open/floor/carpet/royalblack,
/area/misc/condo)
"te" = (
/obj/machinery/door/morgue,
/turf/open/indestructible/hoteltile,
/area/misc/condo)
"tx" = (
/obj/machinery/light/small/directional/north,
/obj/machinery/door/window/survival_pod/left/directional/east,
/turf/open/floor/carpet/royalblack,
/area/misc/condo)
"ut" = (
/obj/effect/turf_decal/siding/wood{
	dir = 8
	},
/obj/structure/chair/sofa/corp/right{
	color = "#DE3A3A"
	},
/turf/open/floor/carpet/royalblack,
/area/misc/condo)
"vU" = (
/obj/machinery/telecomms/relay/preset/auto,
/turf/open/floor/catwalk_floor,
/area/misc/condo)
"vW" = (
/obj/structure/table/wood,
/turf/open/floor/carpet/royalblack,
/area/misc/condo)
"wB" = (
/obj/machinery/computer/slot_machine,
/obj/structure/sign/poster/random/directional/north,
/turf/open/floor/carpet/royalblack,
/area/misc/condo)
"xI" = (
/obj/structure/chair/sofa/corp{
	color = "#DE3A3A"
	},
/obj/structure/sign/poster/random/directional/north,
/turf/open/floor/carpet/royalblack,
/area/misc/condo)
"yz" = (
/turf/open/floor/glass/reinforced,
/area/misc/condo)
"yO" = (
/obj/effect/turf_decal/siding/wood,
/obj/item/choice_beacon/box/plushie,
/obj/structure/table/wood/fancy/purple,
/turf/open/floor/carpet/royalblack,
/area/misc/condo)
"BL" = (
/obj/machinery/light/directional/west,
/turf/open/indestructible/hoteltile,
/area/misc/condo)
"CL" = (
/obj/effect/turf_decal/siding/wood{
	dir = 4
	},
/turf/open/floor/wood/tile,
/area/misc/condo)
"DV" = (
/obj/structure/toilet,
/obj/machinery/light/small/directional/north,
/turf/open/indestructible/hoteltile,
/area/misc/condo)
"EI" = (
/obj/effect/turf_decal/siding/wood{
	dir = 4
	},
/obj/effect/turf_decal/siding/wood{
	dir = 1
	},
/obj/structure/table/wood/fancy/royalblack,
/turf/open/floor/wood/tile,
/area/misc/condo)
"Fz" = (
/obj/structure/chair/sofa/corp/left{
	color = "#DE3A3A"
	},
/turf/open/floor/carpet/royalblack,
/area/misc/condo)
"FA" = (
/obj/effect/turf_decal/siding/wood{
	dir = 8
	},
/obj/structure/chair/sofa/corp/right{
	color = "#DE3A3A"
	},
/obj/structure/window/reinforced/tinted/spawner/directional/north,
/turf/open/floor/carpet/royalblack,
/area/misc/condo)
"GV" = (
/turf/open/indestructible/hoteltile,
/area/misc/condo)
"Hs" = (
/obj/structure/chair/sofa/corp/left{
	color = "#DE3A3A";
	dir = 1
	},
/obj/effect/turf_decal/siding/wood{
	dir = 8
	},
/obj/structure/window/reinforced/tinted/spawner/directional/south,
/turf/open/floor/carpet/royalblack,
/area/misc/condo)
"Hy" = (
/obj/structure/chair/sofa/corp/right{
	color = "#DE3A3A";
	dir = 1
	},
/obj/structure/window/reinforced/tinted/spawner/directional/south,
/turf/open/floor/carpet/royalblack,
/area/misc/condo)
"Ik" = (
/obj/structure/chair/sofa/corp{
	color = "#DE3A3A"
	},
/obj/structure/window/reinforced/tinted/spawner/directional/north,
/turf/open/floor/carpet/royalblack,
/area/misc/condo)
"Ji" = (
/obj/machinery/jukebox/disco{
	anchored = 1;
	req_one_access = null;
	area_limited = 1
	},
/turf/open/floor/carpet/black,
/area/misc/condo)
"Jn" = (
/obj/structure/sign/poster/random/directional/north,
/turf/open/floor/carpet/royalblack,
/area/misc/condo)
"Mr" = (
/obj/machinery/light{
	dir = 1
	},
/obj/machinery/vending/games{
	shut_up = 1
	},
/turf/open/floor/carpet/black,
/area/misc/condo)
"Mz" = (
/obj/structure/chair/sofa/corp/left{
	color = "#DE3A3A"
	},
/obj/structure/window/reinforced/tinted/spawner/directional/north,
/turf/open/floor/carpet/royalblack,
/area/misc/condo)
"MV" = (
/turf/closed/wall,
/area/misc/condo)
"OA" = (
/obj/structure/chair/sofa/corp/right{
	color = "#DE3A3A";
	dir = 1
	},
/turf/open/floor/carpet/royalblack,
/area/misc/condo)
"Pz" = (
/obj/machinery/light_switch/directional/west,
/obj/structure/sink/kitchen/directional/east,
/turf/open/floor/wood/tile,
/area/misc/condo)
"PG" = (
/obj/machinery/smartfridge/drinks,
/turf/open/floor/wood/tile,
/area/misc/condo)
"PJ" = (
/obj/structure/chair/sofa/corp{
	color = "#DE3A3A";
	dir = 1
	},
/obj/structure/window/reinforced/tinted/spawner/directional/south,
/turf/open/floor/carpet/royalblack,
/area/misc/condo)
"QC" = (
/obj/structure/sign/poster/contraband/random/directional/north,
/turf/open/floor/carpet/royalblack,
/area/misc/condo)
"QE" = (
/obj/effect/turf_decal/siding/wood{
	dir = 4
	},
/obj/structure/table/wood/fancy/royalblack,
/obj/machinery/light/directional/south,
/obj/structure/sign/poster/random/directional/south,
/turf/open/floor/wood/tile,
/area/misc/condo)
"RL" = (
/obj/structure/lattice,
/turf/open/space/bluespace,
/area/misc/condo)
"SW" = (
/obj/structure/sign/poster/contraband/random/directional/south,
/turf/open/floor/carpet/black,
/area/misc/condo)
"Tk" = (
/obj/structure/table,
/obj/structure/bedsheetbin,
/turf/open/indestructible/hoteltile,
/area/misc/condo)
"Tx" = (
/obj/structure/chair/sofa/corp{
	color = "#DE3A3A";
	dir = 1
	},
/turf/open/floor/carpet/royalblack,
/area/misc/condo)
"TA" = (
/obj/structure/window/reinforced/survival_pod/spawner/directional/west,
/turf/open/floor/carpet/black,
/area/misc/condo)
"UE" = (
/obj/effect/turf_decal/siding/wood{
	dir = 1
	},
/obj/structure/table/wood/fancy/royalblack,
/obj/effect/spawner/random/food_or_drink/three_course_meal,
/turf/open/floor/wood/tile,
/area/misc/condo)
"UR" = (
/obj/machinery/light/small/directional/north,
/turf/open/floor/carpet/royalblack,
/area/misc/condo)
"VY" = (
/obj/structure/chair/stool/bar,
/obj/machinery/room_controller/directional/west,
/turf/open/floor/carpet/black,
/area/misc/condo)
"We" = (
/obj/machinery/vending/snack/teal,
/turf/open/floor/carpet/black,
/area/misc/condo)
"Wg" = (
/obj/machinery/light/directional/west,
/turf/open/floor/carpet/black,
/area/misc/condo)
"WO" = (
/obj/machinery/vending/dorms,
/turf/open/indestructible/hoteltile,
/area/misc/condo)
"Xr" = (
/turf/open/space/bluespace,
/area/misc/condo)
"Zn" = (
/obj/structure/chair/sofa/corp/left{
	color = "#DE3A3A";
	dir = 1
	},
/obj/effect/turf_decal/siding/wood{
	dir = 8
	},
/turf/open/floor/carpet/royalblack,
/area/misc/condo)
"ZE" = (
/turf/closed/indestructible/steel,
/area/misc/condo)

(1,1,1) = {"
Xr
Xr
Xr
Xr
Xr
Xr
Xr
Xr
Xr
Xr
Xr
Xr
Xr
Xr
Xr
Xr
"}
(2,1,1) = {"
Xr
Xr
ZE
ZE
ZE
ZE
ZE
ZE
kQ
ZE
ZE
ZE
ZE
ZE
ZE
Xr
"}
(3,1,1) = {"
Xr
vU
ZE
Jn
ee
pr
yO
Wg
yz
VY
nQ
af
Pz
li
ZE
Xr
"}
(4,1,1) = {"
Xr
RL
ZE
tx
kB
qQ
nj
cK
yz
dy
nQ
af
af
lS
ZE
Xr
"}
(5,1,1) = {"
Xr
RL
ZE
QC
hi
hi
kr
cK
yz
dy
dR
af
af
oH
ZE
Xr
"}
(6,1,1) = {"
Xr
RL
ZE
UR
ee
ee
sm
cK
yz
dy
UE
af
af
fo
ZE
Xr
"}
(7,1,1) = {"
Xr
RL
ZE
wB
hi
ee
sm
cK
yz
dy
nQ
af
af
PG
ZE
Xr
"}
(8,1,1) = {"
Xr
Xr
ZE
MV
MV
MV
MV
Ji
yz
dy
EI
CL
CL
QE
ZE
Xr
"}
(9,1,1) = {"
Xr
Xr
jj
sU
BL
GV
te
cK
yz
cK
TA
TA
qn
TA
ZE
Xr
"}
(10,1,1) = {"
Xr
Xr
jj
sU
lT
GV
MV
Mr
yz
yz
yz
yz
yz
yz
ZE
Xr
"}
(11,1,1) = {"
Xr
Xr
ZE
MV
MV
GV
MV
We
cK
cK
cK
cK
cK
SW
ZE
Xr
"}
(12,1,1) = {"
Xr
Xr
ZE
DV
te
GV
MV
MV
ut
sY
Hs
FA
sY
Zn
ZE
Xr
"}
(13,1,1) = {"
Xr
Xr
ZE
MV
MV
GV
Tk
MV
xI
vW
PJ
Ik
vW
Tx
ZE
Xr
"}
(14,1,1) = {"
Xr
Xr
ZE
DV
te
GV
WO
MV
Fz
kp
Hy
Mz
kC
OA
ZE
Xr
"}
(15,1,1) = {"
Xr
Xr
ZE
ZE
ZE
ZE
ZE
ZE
ZE
ZE
ZE
ZE
ZE
ZE
ZE
Xr
"}
(16,1,1) = {"
Xr
Xr
Xr
Xr
Xr
Xr
Xr
Xr
Xr
Xr
Xr
Xr
Xr
Xr
Xr
Xr
"}
