//MAP CONVERTED BY dmm2tgm.py THIS HEADER COMMENT PREVENTS RECONVERSION, DO NOT REMOVE
"ap" = (
/obj/structure/flora/tree/jungle,
/turf/open/misc/grass,
/area/misc/condo)
"aK" = (
/obj/machinery/light/directional,
/obj/structure/table/reinforced,
/obj/effect/spawner/random/food_or_drink/three_course_meal,
/turf/open/floor/pod/dark,
/area/misc/condo)
"bl" = (
/obj/structure/chair/sofa/bench/right,
/turf/open/floor/pod/dark,
/area/misc/condo)
"bD" = (
/obj/structure/chair/office{
	dir = 8
	},
/turf/open/floor/wood,
/area/misc/condo)
"bL" = (
/obj/structure/fans,
/obj/effect/mapping_helpers/broken_machine,
/turf/open/floor/pod/dark,
/area/misc/condo)
"bP" = (
/obj/effect/turf_decal/siding/wood,
/obj/item/kirbyplants,
/turf/open/floor/wood,
/area/misc/condo)
"cA" = (
/turf/closed/wall/mineral/titanium/survival/pod,
/area/misc/condo)
"eg" = (
/obj/structure/flora/rock,
/turf/open/floor/fakebasalt,
/area/misc/condo)
"eH" = (
/obj/structure/flora/rock/pile/icy,
/turf/open/misc/dirt/dark/station,
/area/misc/condo)
"fj" = (
/obj/item/bikehorn/rubberducky{
	pixel_y = -7
	},
/turf/open/water/jungle,
/area/misc/condo)
"fX" = (
/turf/open/misc/grass,
/area/misc/condo)
"hj" = (
/turf/open/floor/fakebasalt,
/area/misc/condo)
"jg" = (
/obj/structure/flora/biolumi/mine,
/turf/open/water/jungle,
/area/misc/condo)
"jv" = (
/obj/structure/flora/grass/jungle,
/turf/open/misc/grass,
/area/misc/condo)
"jy" = (
/obj/effect/turf_decal/box,
/obj/structure/ore_box,
/turf/open/floor/pod/dark,
/area/misc/condo)
"jE" = (
/obj/item/toy/beach_ball,
/turf/open/water/jungle,
/area/misc/condo)
"kd" = (
/obj/effect/turf_decal{
	dir = 4
	},
/obj/effect/turf_decal/vg_decals/numbers/six,
/turf/open/floor/pod/dark{
	pixel_x = 0;
	pixel_y = 0
	},
/area/misc/condo)
"ln" = (
/obj/structure/flora/rock/pile,
/turf/open/floor/fakebasalt,
/area/misc/condo)
"lw" = (
/obj/structure/fans/tiny/invisible,
/obj/machinery/door/airlock/survival_pod/glass,
/turf/open/floor/pod/dark,
/area/misc/condo)
"mo" = (
/turf/closed/indestructible/rock,
/area/misc/condo)
"mC" = (
/obj/effect/turf_decal/siding/wood{
	dir = 5
	},
/obj/structure/table/wood,
/obj/item/paper_bin,
/obj/item/pen/red,
/turf/open/floor/wood,
/area/misc/condo)
"nl" = (
/obj/effect/turf_decal/siding/wood{
	dir = 10
	},
/turf/open/floor/wood,
/area/misc/condo)
"ns" = (
/obj/structure/dresser,
/turf/open/floor/carpet/royalblack,
/area/misc/condo)
"oh" = (
/obj/structure/rack,
/obj/item/shovel{
	pixel_x = 2;
	pixel_y = -4
	},
/obj/item/pickaxe{
	pixel_x = 1;
	pixel_y = 2
	},
/obj/item/pickaxe{
	pixel_x = -4;
	pixel_y = 2
	},
/obj/effect/turf_decal/bot_white,
/obj/effect/turf_decal{
	dir = 1
	},
/obj/effect/turf_decal{
	dir = 4
	},
/turf/open/floor/pod/dark,
/area/misc/condo)
"os" = (
/obj/item/storage/box/donkpockets{
	pixel_y = 7;
	pixel_x = 0
	},
/obj/machinery/light/directional,
/obj/structure/table/survival_pod,
/turf/open/floor/pod/dark,
/area/misc/condo)
"oO" = (
/obj/structure/table/reinforced,
/turf/open/floor/pod/dark,
/area/misc/condo)
"oP" = (
/obj/structure/flora/rock/pile/jungle/style_random,
/turf/open/misc/grass,
/area/misc/condo)
"rK" = (
/turf/open/water/jungle,
/area/misc/condo)
"sf" = (
/obj/structure/flora/rock/pile/icy,
/turf/open/floor/fakebasalt,
/area/misc/condo)
"sw" = (
/obj/effect/turf_decal/siding/wood{
	dir = 6
	},
/obj/machinery/vending/dorms,
/turf/open/floor/wood,
/area/misc/condo)
"tq" = (
/obj/machinery/telecomms/relay/preset/auto,
/turf/open/floor/pod/dark,
/area/misc/condo)
"tU" = (
/obj/machinery/door/airlock/survival_pod,
/turf/open/floor/pod/dark,
/area/misc/condo)
"uD" = (
/obj/structure/fans/tiny/invisible,
/obj/effect/spawner/structure/window/survival_pod,
/turf/open/floor/plating,
/area/misc/condo)
"va" = (
/obj/effect/turf_decal/siding/wood{
	dir = 4
	},
/turf/open/floor/wood,
/area/misc/condo)
"wC" = (
/turf/open/floor/pod/dark,
/area/misc/condo)
"wD" = (
/obj/effect/turf_decal{
	dir = 4
	},
/turf/open/floor/pod/dark,
/area/misc/condo)
"wO" = (
/obj/structure/flora/rock/pile/jungle/style_random,
/turf/open/misc/dirt/dark/station,
/area/misc/condo)
"xo" = (
/obj/structure/curtain,
/obj/item/soap/nanotrasen,
/obj/machinery/shower/directional/north,
/turf/open/floor/pod/dark,
/area/misc/condo)
"yq" = (
/obj/effect/spawner/structure/window/survival_pod,
/obj/structure/fans/tiny/invisible,
/turf/open/floor/plating,
/area/misc/condo)
"yP" = (
/obj/structure/flora/grass/jungle/b,
/obj/structure/flora/tree/jungle/small,
/turf/open/misc/grass,
/area/misc/condo)
"Ad" = (
/obj/structure/closet/cabinet,
/obj/structure/sign/poster/contraband/random/directional/west,
/turf/open/floor/carpet/royalblack,
/area/misc/condo)
"Bo" = (
/obj/effect/turf_decal/vg_decals/department/mining,
/turf/open/floor/pod/dark,
/area/misc/condo)
"BP" = (
/obj/effect/turf_decal/siding/wood{
	dir = 8
	},
/obj/effect/turf_decal/siding/wood{
	dir = 9
	},
/turf/open/floor/wood,
/area/misc/condo)
"Cd" = (
/obj/effect/turf_decal/siding/wood{
	dir = 8
	},
/turf/open/floor/wood,
/area/misc/condo)
"Cy" = (
/obj/effect/turf_decal/bot_white,
/obj/machinery/light/directional{
	dir = 1
	},
/obj/structure/rack{
	pixel_x = 0;
	pixel_y = 0
	},
/turf/open/floor/pod/dark,
/area/misc/condo)
"CC" = (
/obj/machinery/room_controller/directional/west,
/turf/open/floor/pod/dark,
/area/misc/condo)
"CQ" = (
/obj/item/toy/plush/bubbleplush,
/turf/open/floor/fakebasalt,
/area/misc/condo)
"Eg" = (
/turf/closed/wall/mineral/titanium/survival/nodiagonal,
/area/misc/condo)
"EA" = (
/obj/machinery/light_switch/directional/north,
/turf/open/floor/carpet/royalblack,
/area/misc/condo)
"EL" = (
/turf/open/misc/dirt/dark/station,
/area/misc/condo)
"EU" = (
/obj/structure/flora/grass/jungle,
/turf/open/misc/dirt/dark/station,
/area/misc/condo)
"GI" = (
/obj/structure/mecha_wreckage/ripley,
/turf/open/floor/fakebasalt,
/area/misc/condo)
"GU" = (
/obj/structure/flora/rock/pile/jungle/style_random,
/turf/open/floor/fakebasalt,
/area/misc/condo)
"IM" = (
/obj/machinery/smartfridge/survival_pod,
/obj/structure/sign/poster/contraband/random/directional/north,
/obj/effect/mapping_helpers/broken_machine,
/turf/open/floor/pod/dark,
/area/misc/condo)
"JL" = (
/turf/closed/indestructible/hoteldoor{
	icon_state = "door_closed";
	icon = 'icons/obj/doors/puzzledoor/default.dmi'
	},
/area/misc/condo)
"Ke" = (
/obj/effect/turf_decal/arrows{
	dir = 1
	},
/turf/open/floor/pod/dark,
/area/misc/condo)
"KW" = (
/obj/structure/rack{
	pixel_x = 0;
	pixel_y = 0
	},
/obj/item/tank/internals/oxygen{
	pixel_x = -6;
	pixel_y = 6
	},
/obj/item/tank/internals/oxygen{
	pixel_x = -3;
	pixel_y = 4
	},
/obj/item/clothing/mask/breath{
	pixel_x = 4;
	pixel_y = 0
	},
/obj/item/clothing/mask/breath{
	pixel_x = -1;
	pixel_y = -3
	},
/obj/effect/turf_decal/bot_white,
/obj/effect/turf_decal{
	dir = 1
	},
/turf/open/floor/pod/dark,
/area/misc/condo)
"KZ" = (
/obj/machinery/microwave,
/obj/machinery/light_switch/directional/west,
/turf/open/floor/pod/dark,
/area/misc/condo)
"Lz" = (
/obj/structure/bed/double/pod{
	dir = 1
	},
/obj/item/bedsheet/brown/double{
	dir = 1
	},
/turf/open/floor/carpet/royalblack,
/area/misc/condo)
"LS" = (
/obj/machinery/door/airlock/survival_pod/glass,
/turf/open/floor/pod/dark,
/area/misc/condo)
"MA" = (
/obj/structure/flora/grass/jungle/b,
/turf/open/misc/grass,
/area/misc/condo)
"Ne" = (
/turf/open/space/bluespace,
/area/misc/condo)
"NF" = (
/obj/machinery/light/small,
/turf/open/water/jungle,
/area/misc/condo)
"Ox" = (
/obj/structure/toilet{
	pixel_x = -4;
	pixel_y = 8
	},
/obj/structure/sink/kitchen/directional/west{
	pixel_y = 11
	},
/obj/machinery/light/directional{
	dir = 8
	},
/turf/open/floor/pod/dark,
/area/misc/condo)
"Pl" = (
/obj/effect/turf_decal/siding/wood{
	dir = 1
	},
/obj/machinery/light/directional{
	dir = 1
	},
/obj/machinery/computer,
/turf/open/floor/wood,
/area/misc/condo)
"PF" = (
/obj/machinery/light/directional,
/obj/structure/table/wood,
/obj/item/choice_beacon/box/plushie{
	pixel_y = 5
	},
/turf/open/floor/carpet/royalblack,
/area/misc/condo)
"Qi" = (
/obj/machinery/light/small/blacklight/directional/west,
/obj/machinery/portable_atmospherics/canister/air,
/turf/open/misc/dirt/dark/station,
/area/misc/condo)
"QJ" = (
/obj/item/gps/computer,
/obj/effect/mapping_helpers/broken_machine,
/turf/open/floor/pod/dark,
/area/misc/condo)
"Rc" = (
/turf/closed/mineral/volcanic,
/area/misc/condo)
"Rl" = (
/obj/structure/mirror/directional/east,
/turf/open/floor/pod/dark,
/area/misc/condo)
"TM" = (
/obj/structure/chair/sofa/bench/left,
/turf/open/floor/pod/dark,
/area/misc/condo)
"Vd" = (
/turf/open/floor/carpet/royalblack,
/area/misc/condo)
"WG" = (
/obj/effect/turf_decal{
	dir = 4
	},
/obj/machinery/light/small/blacklight/directional/west{
	dir = 2
	},
/obj/structure/ore_box,
/obj/effect/turf_decal/box,
/turf/open/floor/pod/dark,
/area/misc/condo)
"Yb" = (
/obj/structure/bonfire/dense,
/turf/open/misc/grass,
/area/misc/condo)
"YN" = (
/obj/structure/rack/shelf,
/obj/item/clothing/shoes/sandal{
	pixel_x = 0;
	pixel_y = -7
	},
/obj/item/clothing/shoes/sandal{
	pixel_x = 0;
	pixel_y = 2
	},
/obj/item/flashlight{
	pixel_x = 0;
	pixel_y = 18
	},
/obj/effect/turf_decal/bot_white,
/turf/open/floor/pod/dark,
/area/misc/condo)
"Zr" = (
/obj/effect/turf_decal/box/white,
/turf/open/floor/pod/dark,
/area/misc/condo)

(1,1,1) = {"
Ne
Ne
Ne
Ne
Ne
Ne
Ne
Ne
Ne
Ne
Ne
Ne
Ne
Ne
Ne
Ne
Ne
Ne
"}
(2,1,1) = {"
Ne
mo
mo
mo
mo
mo
Eg
cA
JL
cA
cA
cA
cA
cA
cA
cA
cA
Ne
"}
(3,1,1) = {"
Ne
mo
mo
rK
rK
rK
cA
Cy
wC
CC
KZ
os
cA
Ad
Lz
ns
cA
Ne
"}
(4,1,1) = {"
Ne
mo
rK
fj
rK
jg
cA
YN
wC
wC
wC
wC
cA
EA
Vd
PF
cA
Ne
"}
(5,1,1) = {"
Ne
mo
rK
jg
jE
rK
uD
bL
wC
Zr
wC
wC
LS
BP
Cd
nl
cA
Ne
"}
(6,1,1) = {"
Ne
mo
rK
rK
rK
rK
cA
IM
wC
wC
bl
aK
cA
Pl
bD
bP
cA
Ne
"}
(7,1,1) = {"
Ne
mo
wO
EL
rK
rK
cA
QJ
wC
wC
TM
oO
cA
mC
va
sw
cA
Ne
"}
(8,1,1) = {"
Ne
mo
fX
EL
EL
NF
Eg
yq
uD
lw
uD
uD
cA
cA
tU
cA
cA
Ne
"}
(9,1,1) = {"
Ne
mo
fX
yP
EU
EL
Qi
KW
Ke
Bo
wC
jy
cA
Ox
Rl
xo
cA
Ne
"}
(10,1,1) = {"
Ne
mo
fX
jv
fX
EL
fX
oh
wD
kd
wD
WG
Eg
cA
cA
cA
cA
Ne
"}
(11,1,1) = {"
Ne
mo
fX
EL
fX
oP
fX
EL
GU
hj
eg
hj
Rc
Rc
cA
tq
cA
Ne
"}
(12,1,1) = {"
Ne
mo
MA
fX
ap
fX
EL
EL
hj
wO
hj
ln
Rc
Rc
Eg
cA
Eg
Ne
"}
(13,1,1) = {"
Ne
mo
fX
EL
EL
Yb
wO
hj
sf
hj
hj
Rc
Rc
Rc
Rc
Rc
mo
Ne
"}
(14,1,1) = {"
Ne
mo
jv
MA
wO
EL
EL
hj
hj
hj
Rc
Rc
Rc
Rc
Rc
CQ
mo
Ne
"}
(15,1,1) = {"
Ne
mo
mo
EL
eH
EL
hj
hj
eg
Rc
Rc
Rc
Rc
hj
hj
hj
mo
Ne
"}
(16,1,1) = {"
Ne
mo
mo
mo
mo
EL
eg
hj
sf
Rc
Rc
Rc
Rc
Rc
GI
hj
mo
Ne
"}
(17,1,1) = {"
Ne
mo
mo
mo
mo
mo
mo
mo
mo
mo
mo
mo
mo
mo
mo
mo
mo
Ne
"}
(18,1,1) = {"
Ne
Ne
Ne
Ne
Ne
Ne
Ne
Ne
Ne
Ne
Ne
Ne
Ne
Ne
Ne
Ne
Ne
Ne
"}
