//MAP CONVERTED BY dmm2tgm.py THIS HEADER COMMENT PREVENTS RECONVERSION, DO NOT REMOVE
"af" = (
/obj/structure/spacevine,
/obj/structure/flora/bush/flowers_br/style_random,
/turf/closed/indestructible/wood,
/area/misc/condo)
"aA" = (
/obj/machinery/light/floor,
/obj/structure/flora/biolumi/flower,
/turf/open/floor/grass,
/area/misc/condo)
"bg" = (
/obj/structure/spacevine,
/obj/structure/flora/bush/flowers_pp/style_random,
/turf/closed/indestructible/wood,
/area/misc/condo)
"dn" = (
/obj/structure/chair/pew{
	dir = 1
	},
/turf/open/floor/wood/tile,
/area/misc/condo)
"fz" = (
/obj/machinery/telecomms/relay/preset/auto,
/turf/open/floor/catwalk_floor,
/area/misc/condo)
"ga" = (
/obj/structure/flora/bush/flowers_pp/style_random,
/turf/open/floor/grass/fairy,
/area/misc/condo)
"gj" = (
/obj/structure/flora/bush/flowers_pp/style_random,
/obj/structure/flora/biolumi/flower,
/turf/open/floor/grass/fairy,
/area/misc/condo)
"gm" = (
/obj/structure/lattice,
/turf/open/space/bluespace,
/area/misc/condo)
"gK" = (
/obj/structure/flora/bush/flowers_br/style_random,
/obj/structure/flora/bush/flowers_br/style_random,
/obj/structure/flora/bush/flowers_br/style_random,
/turf/open/floor/grass,
/area/misc/condo)
"hd" = (
/obj/structure/flora/bush/flowers_pp/style_random,
/obj/structure/flora/bush/flowers_yw/style_random,
/turf/open/floor/grass,
/area/misc/condo)
"hY" = (
/obj/structure/chair/pew/left{
	dir = 1
	},
/turf/open/floor/wood/tile,
/area/misc/condo)
"iy" = (
/obj/structure/flora/bush/flowers_yw/style_random,
/obj/structure/flora/bush/flowers_yw/style_random,
/obj/structure/flora/bush/flowers_br/style_random,
/obj/structure/flora/biolumi/lamp,
/turf/open/floor/grass,
/area/misc/condo)
"ka" = (
/obj/structure/flora/bush/flowers_yw/style_random,
/obj/structure/flora/bush/flowers_pp/style_random,
/obj/structure/flora/bush/flowers_br/style_random,
/turf/open/floor/grass,
/area/misc/condo)
"kh" = (
/obj/structure/flora/bush/flowers_br/style_random,
/obj/structure/flora/biolumi/flower,
/turf/open/floor/grass/fairy,
/area/misc/condo)
"ko" = (
/obj/structure/flora/rock,
/obj/structure/flora/bush/flowers_yw/style_random,
/obj/structure/flora/bush/flowers_br/style_random,
/turf/open/floor/grass,
/area/misc/condo)
"kq" = (
/obj/structure/flora/bush/flowers_pp/style_random,
/obj/structure/flora/bush/flowers_br/style_random,
/obj/structure/flora/bush/flowers_br/style_random,
/turf/open/floor/grass,
/area/misc/condo)
"kP" = (
/obj/structure/flora/bush/flowers_yw/style_random,
/obj/structure/flora/biolumi/lamp,
/turf/open/floor/grass,
/area/misc/condo)
"lH" = (
/obj/structure/chair/pew{
	dir = 4
	},
/turf/open/floor/wood/tile,
/area/misc/condo)
"mQ" = (
/obj/structure/chair/pew/left,
/turf/open/floor/wood/tile,
/area/misc/condo)
"mR" = (
/obj/machinery/light/floor,
/obj/structure/flora/bush/flowers_br/style_random,
/obj/structure/flora/bush/flowers_br/style_random,
/turf/open/floor/grass,
/area/misc/condo)
"oy" = (
/obj/structure/flora/bush/flowers_pp/style_random,
/obj/structure/flora/bush/flowers_pp/style_random,
/turf/open/floor/grass,
/area/misc/condo)
"ph" = (
/obj/structure/flora/bush/flowers_pp/style_random,
/obj/structure/flora/bush/flowers_br/style_random,
/obj/structure/flora/biolumi/lamp,
/turf/open/floor/grass,
/area/misc/condo)
"qq" = (
/obj/structure/flora/bush/flowers_pp/style_random,
/turf/open/floor/grass,
/area/misc/condo)
"qX" = (
/obj/structure/flora/bush/flowers_br/style_random,
/obj/structure/flora/biolumi/flower,
/turf/open/floor/grass,
/area/misc/condo)
"sg" = (
/obj/machinery/light/floor,
/obj/structure/flora/bush/flowers_br/style_random,
/turf/open/floor/grass,
/area/misc/condo)
"th" = (
/obj/structure/flora/tree/jungle{
	pixel_x = -31;
	pixel_y = 0
	},
/obj/structure/flora/bush/flowers_pp/style_random,
/turf/open/floor/grass/fairy,
/area/misc/condo)
"tu" = (
/obj/structure/flora/bush/flowers_yw/style_random,
/obj/structure/flora/bush/flowers_br/style_random,
/obj/structure/flora/bush/flowers_br/style_random,
/turf/open/floor/grass,
/area/misc/condo)
"tY" = (
/turf/open/floor/wood/tile,
/area/misc/condo)
"up" = (
/obj/structure/flora/bush/flowers_pp/style_random,
/obj/structure/flora/bush/flowers_pp/style_random,
/obj/structure/flora/bush/flowers_br/style_random,
/obj/structure/flora/bush/flowers_br/style_random,
/turf/open/floor/grass,
/area/misc/condo)
"uD" = (
/obj/structure/flora/bush/flowers_yw/style_random,
/obj/structure/flora/bush/flowers_br/style_random,
/obj/structure/flora/biolumi/mine,
/turf/open/floor/grass/fairy,
/area/misc/condo)
"uV" = (
/obj/structure/spacevine,
/obj/structure/flora/bush/flowers_br/style_random,
/obj/structure/flora/bush/flowers_yw/style_random,
/turf/closed/indestructible/wood,
/area/misc/condo)
"vd" = (
/obj/structure/chair/pew{
	dir = 8
	},
/turf/open/floor/wood/tile,
/area/misc/condo)
"vA" = (
/obj/structure/flora/bush/flowers_br/style_random,
/obj/structure/flora/bush/flowers_br/style_random,
/turf/open/floor/grass,
/area/misc/condo)
"vT" = (
/obj/structure/flora/bush/flowers_yw/style_random,
/obj/structure/flora/bush/flowers_pp/style_random,
/obj/structure/flora/bush/flowers_br/style_random,
/obj/structure/flora/bush/flowers_br/style_random,
/turf/open/floor/grass,
/area/misc/condo)
"wc" = (
/obj/structure/flora/rock,
/obj/structure/flora/bush/flowers_br/style_random,
/turf/open/floor/grass,
/area/misc/condo)
"zi" = (
/obj/structure/flora/bush/flowers_br/style_random,
/obj/structure/flora/bush/flowers_br/style_random,
/obj/structure/flora/biolumi/flower,
/turf/open/floor/grass/fairy,
/area/misc/condo)
"zn" = (
/obj/structure/spacevine,
/obj/structure/flora/bush/flowers_yw/style_random,
/turf/closed/indestructible/wood,
/area/misc/condo)
"zX" = (
/obj/structure/chair/pew/right{
	dir = 1
	},
/turf/open/floor/wood/tile,
/area/misc/condo)
"AB" = (
/obj/structure/flora/bush/flowers_pp/style_random,
/obj/structure/flora/bush/flowers_br/style_random,
/obj/structure/flora/bush/flowers_br/style_random,
/obj/structure/flora/biolumi/flower,
/turf/open/floor/grass,
/area/misc/condo)
"BR" = (
/obj/structure/flora/bush/flowers_br/style_random,
/turf/open/floor/grass/fairy,
/area/misc/condo)
"Cc" = (
/obj/structure/flora/bush/flowers_br/style_random,
/obj/machinery/room_controller/directional/west,
/turf/open/floor/grass,
/area/misc/condo)
"Cd" = (
/obj/structure/flora/bush/flowers_pp/style_random,
/obj/structure/flora/bush/flowers_pp/style_random,
/obj/structure/flora/bush/flowers_yw/style_random,
/turf/open/floor/grass,
/area/misc/condo)
"Cl" = (
/obj/structure/spacevine,
/obj/structure/flora/bush/flowers_br/style_random,
/obj/structure/flora/bush/flowers_pp/style_random,
/turf/closed/indestructible/wood,
/area/misc/condo)
"CE" = (
/obj/structure/flora/bush/flowers_yw/style_random,
/turf/open/floor/grass,
/area/misc/condo)
"Dd" = (
/obj/structure/spacevine,
/obj/structure/flora/bush/flowers_yw/style_random,
/obj/structure/flora/bush/flowers_pp/style_random,
/turf/closed/indestructible/wood,
/area/misc/condo)
"DH" = (
/obj/structure/flora/bush/flowers_br/style_random,
/obj/structure/flora/bush/flowers_br/style_random,
/obj/structure/flora/biolumi,
/turf/open/floor/grass,
/area/misc/condo)
"DQ" = (
/obj/structure/flora/bush/flowers_br/style_random,
/obj/structure/flora/biolumi/lamp,
/turf/open/floor/grass,
/area/misc/condo)
"Ep" = (
/obj/structure/spacevine,
/obj/structure/flora/bush/flowers_br/style_random,
/obj/structure/flora/bush/flowers_yw/style_random,
/obj/structure/flora/bush/flowers_pp/style_random,
/turf/closed/indestructible/wood,
/area/misc/condo)
"FZ" = (
/obj/structure/flora/biolumi/flower,
/turf/open/floor/grass,
/area/misc/condo)
"Gj" = (
/obj/structure/chair/pew,
/turf/open/floor/wood/tile,
/area/misc/condo)
"GQ" = (
/obj/item/flashlight/flare/candle/infinite,
/turf/open/floor/wood/tile,
/area/misc/condo)
"Hx" = (
/obj/structure/flora/bush/flowers_br/style_random,
/obj/structure/flora/biolumi,
/turf/open/floor/grass,
/area/misc/condo)
"ID" = (
/obj/structure/flora/bush/flowers_pp/style_random,
/obj/structure/flora/bush/flowers_br/style_random,
/turf/open/floor/grass/fairy,
/area/misc/condo)
"JW" = (
/obj/structure/chair/pew,
/obj/item/choice_beacon/box/plushie,
/turf/open/floor/wood/tile,
/area/misc/condo)
"Kc" = (
/obj/structure/flora/rock,
/obj/structure/flora/bush/flowers_br/style_random,
/obj/structure/flora/bush/flowers_pp/style_random,
/turf/open/floor/grass/fairy,
/area/misc/condo)
"Kj" = (
/turf/open/floor/carpet/royalblue,
/area/misc/condo)
"KC" = (
/obj/structure/flora/bush/flowers_br/style_random,
/obj/structure/flora/biolumi/mine,
/turf/open/floor/grass,
/area/misc/condo)
"Lm" = (
/obj/structure/flora/bush/flowers_yw/style_random,
/obj/structure/flora/bush/flowers_br/style_random,
/obj/structure/flora/bush/flowers_br/style_random,
/obj/structure/flora/biolumi/flower,
/turf/open/floor/grass,
/area/misc/condo)
"Mo" = (
/obj/structure/spacevine,
/turf/closed/indestructible/wood,
/area/misc/condo)
"Mv" = (
/obj/structure/flora/bush/flowers_yw/style_random,
/obj/structure/flora/bush/flowers_yw/style_random,
/obj/structure/flora/bush/flowers_br/style_random,
/turf/open/floor/grass,
/area/misc/condo)
"MX" = (
/obj/structure/flora/bush/flowers_pp/style_random,
/obj/structure/flora/bush/flowers_pp/style_random,
/obj/structure/flora/bush/flowers_br/style_random,
/turf/open/floor/grass,
/area/misc/condo)
"Ox" = (
/obj/structure/flora/bush/flowers_pp/style_random,
/obj/structure/flora/bush/flowers_yw/style_random,
/obj/structure/flora/bush/flowers_br/style_random,
/turf/open/floor/grass,
/area/misc/condo)
"OY" = (
/obj/structure/chair/pew/left{
	dir = 4
	},
/turf/open/floor/wood/tile,
/area/misc/condo)
"Qc" = (
/obj/structure/flora/bush/flowers_br/style_random,
/turf/open/floor/grass,
/area/misc/condo)
"Qf" = (
/obj/structure/chair/pew/right,
/turf/open/floor/wood/tile,
/area/misc/condo)
"QL" = (
/obj/structure/chair/pew/right{
	dir = 4
	},
/turf/open/floor/wood/tile,
/area/misc/condo)
"Ri" = (
/turf/open/floor/grass,
/area/misc/condo)
"TH" = (
/obj/structure/flora/bush/flowers_yw/style_random,
/obj/structure/flora/bush/flowers_br/style_random,
/turf/open/floor/grass,
/area/misc/condo)
"Ve" = (
/obj/structure/flora/bush/flowers_pp/style_random,
/obj/structure/flora/bush/flowers_br/style_random,
/turf/open/floor/grass,
/area/misc/condo)
"Vy" = (
/obj/structure/flora/rock,
/obj/machinery/light/floor,
/obj/structure/flora/bush/flowers_br/style_random,
/turf/open/floor/grass,
/area/misc/condo)
"VV" = (
/obj/structure/flora/bush/flowers_br/style_random,
/obj/machinery/vending/dorms,
/obj/structure/spacevine,
/turf/open/floor/grass,
/area/misc/condo)
"We" = (
/obj/structure/chair/pew/left{
	dir = 8
	},
/turf/open/floor/wood/tile,
/area/misc/condo)
"WO" = (
/obj/structure/chair/pew/right{
	dir = 8
	},
/turf/open/floor/wood/tile,
/area/misc/condo)
"WY" = (
/obj/structure/flora/bush/flowers_pp/style_random,
/obj/structure/flora/bush/flowers_br/style_random,
/obj/structure/flora/bush/flowers_br/style_random,
/obj/structure/flora/biolumi,
/obj/structure/flora/biolumi/mine,
/turf/open/floor/grass,
/area/misc/condo)
"Xj" = (
/obj/structure/flora/bush/flowers_pp/style_random,
/obj/item/storage/fancy/heart_box,
/turf/open/floor/grass/fairy,
/area/misc/condo)
"XX" = (
/turf/closed/indestructible/hoteldoor{
	icon_state = "door_closed";
	icon = 'icons/obj/doors/puzzledoor/default.dmi'
	},
/area/misc/condo)
"YG" = (
/obj/structure/flora/bush/flowers_br/style_random,
/obj/structure/flora/biolumi/lamp,
/turf/open/floor/grass/fairy,
/area/misc/condo)
"Zn" = (
/obj/machinery/light/floor,
/turf/open/floor/grass,
/area/misc/condo)

(1,1,1) = {"
gm
gm
gm
bg
Ep
XX
Mo
Dd
af
zn
Dd
zn
af
gm
gm
gm
"}
(2,1,1) = {"
gm
gm
Cl
VV
TH
TH
Cc
iy
tu
vA
vA
tu
Hx
zn
gm
gm
"}
(3,1,1) = {"
gm
zn
qX
CE
hd
CE
CE
hd
Ri
up
vA
tu
CE
Qc
Dd
gm
"}
(4,1,1) = {"
Dd
kq
ko
CE
sg
tY
QL
lH
lH
OY
tY
aA
CE
Mv
FZ
zn
"}
(5,1,1) = {"
zn
KC
hd
Zn
tY
tY
GQ
Kj
Kj
GQ
tY
tY
Zn
CE
Qc
zn
"}
(6,1,1) = {"
bg
Ve
Cd
tY
tY
tY
tY
tY
tY
tY
tY
tY
tY
hd
Qc
Ep
"}
(7,1,1) = {"
Cl
ph
oy
mQ
GQ
tY
kh
ID
BR
Kc
tY
GQ
hY
Ox
Ve
uV
"}
(8,1,1) = {"
zn
MX
vT
Gj
Kj
tY
BR
gj
th
zi
tY
Kj
dn
hd
Qc
Dd
"}
(9,1,1) = {"
uV
qq
Qc
JW
Kj
tY
YG
ga
ID
Xj
tY
Kj
dn
qq
WY
af
"}
(10,1,1) = {"
zn
Ve
DQ
Qf
GQ
tY
kh
BR
uD
BR
tY
GQ
zX
qq
Hx
bg
"}
(11,1,1) = {"
zn
up
Qc
tY
tY
tY
tY
tY
tY
tY
tY
tY
tY
qq
CE
uV
"}
(12,1,1) = {"
Ep
Ve
AB
sg
tY
tY
GQ
Kj
Kj
GQ
tY
tY
aA
kq
Qc
bg
"}
(13,1,1) = {"
Dd
Qc
ka
gK
Vy
tY
We
vd
vd
WO
tY
mR
kq
wc
qX
zn
"}
(14,1,1) = {"
gm
bg
KC
Qc
vA
vA
TH
CE
kP
TH
Qc
Ve
up
vA
bg
gm
"}
(15,1,1) = {"
gm
gm
zn
Hx
CE
CE
Lm
Qc
TH
vA
Qc
DH
vA
bg
gm
fz
"}
(16,1,1) = {"
gm
gm
gm
bg
Cl
Dd
Cl
Dd
zn
Ep
zn
Dd
Ep
gm
gm
gm
"}
