//MAP CONVERTED BY dmm2tgm.py THIS HEADER COMMENT PREVENTS RECONVERSION, DO NOT REMOVE
"a" = (
/turf/open/moving/auto_icon/groups/group_3,
/area/trainstation/outdoor/rails)
"c" = (
/obj/effect/landmark/trainstation/object_spawner/backdrop,
/turf/open/moving/auto_icon/groups/group_6,
/area/trainstation/outdoor/rails)
"d" = (
/turf/open/moving/auto_icon/groups/group_9,
/area/trainstation/outdoor/rails)
"f" = (
/turf/open/moving/auto_icon/groups/group_17{
	fake = 1
	},
/area/trainstation/outdoor/rails)
"g" = (
/obj/effect/landmark/trainstation/object_spawner/center,
/turf/open/moving/auto_icon/groups/group_5,
/area/trainstation/outdoor/rails)
"i" = (
/turf/open/moving/auto_icon/groups/group_15{
	fake = 1
	},
/area/trainstation/outdoor/rails)
"j" = (
/obj/effect/landmark/trainstation/object_spawner/backdrop,
/turf/open/moving/auto_icon/groups/group_8,
/area/trainstation/outdoor/rails)
"l" = (
/obj/effect/landmark/trainstation/object_spawner/center,
/turf/open/moving/auto_icon/groups/group_7,
/area/trainstation/outdoor/rails)
"m" = (
/turf/open/moving/auto_icon/groups/group_13{
	fake = 1
	},
/area/trainstation/outdoor/rails)
"n" = (
/turf/open/moving/auto_icon/groups/group_10,
/area/trainstation/outdoor/rails)
"o" = (
/obj/effect/landmark/trainstation/object_spawner/near_rails,
/turf/open/moving/auto_icon/groups/group_3,
/area/trainstation/outdoor/rails)
"q" = (
/obj/effect/landmark/trainstation/object_spawner/foreign_special,
/turf/open/moving/auto_icon/groups/group_10,
/area/trainstation/outdoor/rails)
"r" = (
/turf/open/moving/auto_icon/groups/group_7,
/area/trainstation/outdoor/rails)
"t" = (
/obj/effect/landmark/trainstation/object_spawner/near_rails_secondnary,
/turf/open/moving/auto_icon/groups/group_2,
/area/trainstation/outdoor/rails)
"v" = (
/obj/effect/landmark/trainstation/object_spawner/center,
/turf/open/moving/auto_icon/groups/group_6,
/area/trainstation/outdoor/rails)
"y" = (
/turf/open/moving/auto_icon/groups/group_16{
	fake = 1
	},
/area/trainstation/outdoor/rails)
"C" = (
/turf/open/moving/auto_icon/groups/group_4,
/area/trainstation/outdoor/rails)
"D" = (
/turf/open/moving/auto_icon/groups/group_6,
/area/trainstation/outdoor/rails)
"E" = (
/obj/effect/landmark/trainstation/object_spawner/center_special,
/turf/open/moving/auto_icon/groups/group_7,
/area/trainstation/outdoor/rails)
"F" = (
/turf/open/moving/auto_icon/groups/group_5,
/area/trainstation/outdoor/rails)
"G" = (
/obj/effect/landmark/trainstation/object_spawner/backdrop,
/turf/open/moving/auto_icon/groups/group_4,
/area/trainstation/outdoor/rails)
"H" = (
/turf/open/moving/auto_icon/groups/group_1,
/area/trainstation/outdoor/rails)
"K" = (
/turf/open/moving/auto_icon/groups/group_8,
/area/trainstation/outdoor/rails)
"M" = (
/obj/effect/landmark/trainstation/object_spawner/foreign,
/turf/open/moving/auto_icon/groups/group_9,
/area/trainstation/outdoor/rails)
"P" = (
/turf/open/moving/auto_icon/groups/group_2,
/area/trainstation/outdoor/rails)
"R" = (
/turf/open/moving/auto_icon/groups/group_11,
/area/trainstation/outdoor/rails)
"U" = (
/turf/open/moving/auto_icon/groups/group_18{
	fake = 1;
	opacity = 1
	},
/area/trainstation/outdoor/rails)
"W" = (
/turf/open/moving/auto_icon/groups/group_12{
	fake = 1;
	density = 1
	},
/area/trainstation/outdoor/rails)
"X" = (
/turf/open/moving/auto_icon/groups/group_14{
	fake = 1
	},
/area/trainstation/outdoor/rails)

(1,1,1) = {"
U
f
f
y
y
i
i
X
X
m
m
W
W
R
R
n
d
K
r
D
F
C
a
P
H
"}
(2,1,1) = {"
U
f
f
y
y
i
i
X
X
m
m
W
W
R
R
n
d
K
r
D
F
C
a
P
H
"}
(3,1,1) = {"
U
f
f
y
y
i
i
X
X
m
m
W
W
R
R
n
d
K
r
D
F
C
a
P
H
"}
(4,1,1) = {"
U
f
f
y
y
i
i
X
X
m
m
W
W
R
R
n
d
K
r
D
F
C
a
P
H
"}
(5,1,1) = {"
U
f
f
y
y
i
i
X
X
m
m
W
W
R
R
n
d
K
r
D
F
C
a
P
H
"}
(6,1,1) = {"
U
f
f
y
y
i
i
X
X
m
m
W
W
R
R
n
d
K
r
D
F
C
a
P
H
"}
(7,1,1) = {"
U
f
f
y
y
i
i
X
X
m
m
W
W
R
R
n
d
K
r
D
F
C
a
P
H
"}
(8,1,1) = {"
U
f
f
y
y
i
i
X
X
m
m
W
W
R
R
n
d
K
r
D
F
C
a
P
H
"}
(9,1,1) = {"
U
f
f
y
y
i
i
X
X
m
m
W
W
R
R
n
d
K
r
D
F
C
a
P
H
"}
(10,1,1) = {"
U
f
f
y
y
i
i
X
X
m
m
W
W
R
R
n
d
K
r
D
F
C
a
P
H
"}
(11,1,1) = {"
U
f
f
y
y
i
i
X
X
m
m
W
W
R
R
n
d
K
r
D
F
C
a
P
H
"}
(12,1,1) = {"
U
f
f
y
y
i
i
X
X
m
m
W
W
R
R
n
d
K
r
D
F
C
a
P
H
"}
(13,1,1) = {"
U
f
f
y
y
i
i
X
X
m
m
W
W
R
R
n
d
K
r
D
F
C
a
P
H
"}
(14,1,1) = {"
U
f
f
y
y
i
i
X
X
m
m
W
W
R
R
n
d
K
r
D
F
C
a
P
H
"}
(15,1,1) = {"
U
f
f
y
y
i
i
X
X
m
m
W
W
R
R
n
d
K
r
D
F
C
a
P
H
"}
(16,1,1) = {"
U
f
f
y
y
i
i
X
X
m
m
W
W
R
R
n
d
K
r
D
F
C
a
P
H
"}
(17,1,1) = {"
U
f
f
y
y
i
i
X
X
m
m
W
W
R
R
n
d
K
r
D
F
C
a
P
H
"}
(18,1,1) = {"
U
f
f
y
y
i
i
X
X
m
m
W
W
R
R
n
d
K
r
D
F
C
a
P
H
"}
(19,1,1) = {"
U
f
f
y
y
i
i
X
X
m
m
W
W
R
R
n
d
K
r
D
F
C
a
P
H
"}
(20,1,1) = {"
U
f
f
y
y
i
i
X
X
m
m
W
W
R
R
n
d
K
r
D
F
C
a
P
H
"}
(21,1,1) = {"
U
f
f
y
y
i
i
X
X
m
m
W
W
R
R
n
d
K
r
D
F
C
a
P
H
"}
(22,1,1) = {"
U
f
f
y
y
i
i
X
X
m
m
W
W
R
R
n
d
K
r
D
F
C
a
P
H
"}
(23,1,1) = {"
U
f
f
y
y
i
i
X
X
m
m
W
W
R
R
n
d
K
r
D
F
C
a
P
H
"}
(24,1,1) = {"
U
f
f
y
y
i
i
X
X
m
m
W
W
R
R
n
d
K
r
D
F
C
a
P
H
"}
(25,1,1) = {"
U
f
f
y
y
i
i
X
X
m
m
W
W
R
R
n
d
K
r
D
F
C
a
P
H
"}
(26,1,1) = {"
U
f
f
y
y
i
i
X
X
m
m
W
W
R
R
n
d
K
r
D
F
C
a
P
H
"}
(27,1,1) = {"
U
f
f
y
y
i
i
X
X
m
m
W
W
R
R
n
d
K
r
D
F
C
a
P
H
"}
(28,1,1) = {"
U
f
f
y
y
i
i
X
X
m
m
W
W
R
R
n
d
K
r
D
F
C
a
P
H
"}
(29,1,1) = {"
U
f
f
y
y
i
i
X
X
m
m
W
W
R
R
n
d
K
r
D
F
C
a
P
H
"}
(30,1,1) = {"
U
f
f
y
y
i
i
X
X
m
m
W
W
R
R
n
d
K
r
D
F
C
a
P
H
"}
(31,1,1) = {"
U
f
f
y
y
i
i
X
X
m
m
W
W
R
R
n
d
K
r
D
F
C
a
P
H
"}
(32,1,1) = {"
U
f
f
y
y
i
i
X
X
m
m
W
W
R
R
n
d
K
r
D
F
C
a
P
H
"}
(33,1,1) = {"
U
f
f
y
y
i
i
X
X
m
m
W
W
R
R
n
d
K
r
D
F
C
a
P
H
"}
(34,1,1) = {"
U
f
f
y
y
i
i
X
X
m
m
W
W
R
R
n
d
K
r
D
F
C
a
P
H
"}
(35,1,1) = {"
U
f
f
y
y
i
i
X
X
m
m
W
W
R
R
n
d
K
r
D
F
C
a
P
H
"}
(36,1,1) = {"
U
f
f
y
y
i
i
X
X
m
m
W
W
R
R
n
d
K
r
D
F
C
a
P
H
"}
(37,1,1) = {"
U
f
f
y
y
i
i
X
X
m
m
W
W
R
R
n
d
K
r
D
F
C
a
P
H
"}
(38,1,1) = {"
U
f
f
y
y
i
i
X
X
m
m
W
W
R
R
n
d
K
r
D
F
C
a
P
H
"}
(39,1,1) = {"
U
f
f
y
y
i
i
X
X
m
m
W
W
R
R
n
d
K
r
D
F
C
a
P
H
"}
(40,1,1) = {"
U
f
f
y
y
i
i
X
X
m
m
W
W
R
R
n
d
K
r
D
F
C
a
P
H
"}
(41,1,1) = {"
U
f
f
y
y
i
i
X
X
m
m
W
W
R
R
n
d
K
r
D
F
C
a
P
H
"}
(42,1,1) = {"
U
f
f
y
y
i
i
X
X
m
m
W
W
R
R
n
d
K
r
D
F
C
a
P
H
"}
(43,1,1) = {"
U
f
f
y
y
i
i
X
X
m
m
W
W
R
R
n
d
K
r
D
F
C
a
P
H
"}
(44,1,1) = {"
U
f
f
y
y
i
i
X
X
m
m
W
W
R
R
n
d
K
r
D
F
C
a
P
H
"}
(45,1,1) = {"
U
f
f
y
y
i
i
X
X
m
m
W
W
R
R
n
d
K
r
D
F
C
a
P
H
"}
(46,1,1) = {"
U
f
f
y
y
i
i
X
X
m
m
W
W
R
R
n
d
K
r
D
F
C
a
P
H
"}
(47,1,1) = {"
U
f
f
y
y
i
i
X
X
m
m
W
W
R
R
n
d
K
r
D
F
C
a
P
H
"}
(48,1,1) = {"
U
f
f
y
y
i
i
X
X
m
m
W
W
R
R
n
d
K
r
D
F
C
a
P
H
"}
(49,1,1) = {"
U
f
f
y
y
i
i
X
X
m
m
W
W
R
R
n
d
K
r
D
F
C
a
P
H
"}
(50,1,1) = {"
U
f
f
y
y
i
i
X
X
m
m
W
W
R
R
n
d
K
r
D
F
C
a
P
H
"}
(51,1,1) = {"
U
f
f
y
y
i
i
X
X
m
m
W
W
R
R
n
d
K
r
D
F
C
a
P
H
"}
(52,1,1) = {"
U
f
f
y
y
i
i
X
X
m
m
W
W
R
R
n
d
K
r
D
F
C
a
P
H
"}
(53,1,1) = {"
U
f
f
y
y
i
i
X
X
m
m
W
W
R
R
n
d
K
r
D
F
C
a
P
H
"}
(54,1,1) = {"
U
f
f
y
y
i
i
X
X
m
m
W
W
R
R
n
d
K
r
D
F
C
a
P
H
"}
(55,1,1) = {"
U
f
f
y
y
i
i
X
X
m
m
W
W
R
R
n
d
K
r
D
F
C
a
P
H
"}
(56,1,1) = {"
U
f
f
y
y
i
i
X
X
m
m
W
W
R
R
n
d
K
r
D
F
C
a
P
H
"}
(57,1,1) = {"
U
f
f
y
y
i
i
X
X
m
m
W
W
R
R
n
d
K
r
D
F
C
a
P
H
"}
(58,1,1) = {"
U
f
f
y
y
i
i
X
X
m
m
W
W
R
R
n
d
K
r
D
F
C
a
P
H
"}
(59,1,1) = {"
U
f
f
y
y
i
i
X
X
m
m
W
W
R
R
n
d
K
r
D
F
C
a
P
H
"}
(60,1,1) = {"
U
f
f
y
y
i
i
X
X
m
m
W
W
R
R
n
d
K
r
D
F
C
a
P
H
"}
(61,1,1) = {"
U
f
f
y
y
i
i
X
X
m
m
W
W
R
R
n
d
K
r
D
F
C
a
P
H
"}
(62,1,1) = {"
U
f
f
y
y
i
i
X
X
m
m
W
W
R
R
n
d
K
r
D
F
C
a
P
H
"}
(63,1,1) = {"
U
f
f
y
y
i
i
X
X
m
m
W
W
R
R
n
d
K
r
D
F
C
a
P
H
"}
(64,1,1) = {"
U
f
f
y
y
i
i
X
X
m
m
W
W
R
R
n
d
K
r
D
F
C
a
P
H
"}
(65,1,1) = {"
U
f
f
y
y
i
i
X
X
m
m
W
W
R
R
n
d
K
r
D
F
C
a
P
H
"}
(66,1,1) = {"
U
f
f
y
y
i
i
X
X
m
m
W
W
R
R
n
d
K
r
D
F
C
a
P
H
"}
(67,1,1) = {"
U
f
f
y
y
i
i
X
X
m
m
W
W
R
R
n
d
K
r
D
F
C
a
P
H
"}
(68,1,1) = {"
U
f
f
y
y
i
i
X
X
m
m
W
W
R
R
n
d
K
r
D
F
C
a
P
H
"}
(69,1,1) = {"
U
f
f
y
y
i
i
X
X
m
m
W
W
R
R
n
d
K
r
D
F
C
a
P
H
"}
(70,1,1) = {"
U
f
f
y
y
i
i
X
X
m
m
W
W
R
R
n
d
K
r
D
F
C
a
P
H
"}
(71,1,1) = {"
U
f
f
y
y
i
i
X
X
m
m
W
W
R
R
n
d
K
r
D
F
C
a
P
H
"}
(72,1,1) = {"
U
f
f
y
y
i
i
X
X
m
m
W
W
R
R
n
d
K
r
D
F
C
a
P
H
"}
(73,1,1) = {"
U
f
f
y
y
i
i
X
X
m
m
W
W
R
R
n
d
K
r
D
F
C
a
P
H
"}
(74,1,1) = {"
U
f
f
y
y
i
i
X
X
m
m
W
W
R
R
n
d
K
r
D
F
C
a
P
H
"}
(75,1,1) = {"
U
f
f
y
y
i
i
X
X
m
m
W
W
R
R
n
d
K
r
D
F
C
a
P
H
"}
(76,1,1) = {"
U
f
f
y
y
i
i
X
X
m
m
W
W
R
R
n
d
K
r
D
F
C
a
P
H
"}
(77,1,1) = {"
U
f
f
y
y
i
i
X
X
m
m
W
W
R
R
n
d
K
r
D
F
C
a
P
H
"}
(78,1,1) = {"
U
f
f
y
y
i
i
X
X
m
m
W
W
R
R
n
d
K
r
D
F
C
a
P
H
"}
(79,1,1) = {"
U
f
f
y
y
i
i
X
X
m
m
W
W
R
R
n
d
K
r
D
F
C
a
P
H
"}
(80,1,1) = {"
U
f
f
y
y
i
i
X
X
m
m
W
W
R
R
n
d
K
r
D
F
C
a
P
H
"}
(81,1,1) = {"
U
f
f
y
y
i
i
X
X
m
m
W
W
R
R
n
d
K
r
D
F
C
a
P
H
"}
(82,1,1) = {"
U
f
f
y
y
i
i
X
X
m
m
W
W
R
R
n
d
K
r
D
F
C
a
P
H
"}
(83,1,1) = {"
U
f
f
y
y
i
i
X
X
m
m
W
W
R
R
n
d
K
r
D
F
C
a
P
H
"}
(84,1,1) = {"
U
f
f
y
y
i
i
X
X
m
m
W
W
R
R
n
d
K
r
D
F
C
a
P
H
"}
(85,1,1) = {"
U
f
f
y
y
i
i
X
X
m
m
W
W
R
R
n
d
K
r
D
F
C
a
P
H
"}
(86,1,1) = {"
U
f
f
y
y
i
i
X
X
m
m
W
W
R
R
n
d
K
r
D
F
C
a
P
H
"}
(87,1,1) = {"
U
f
f
y
y
i
i
X
X
m
m
W
W
R
R
n
d
K
r
D
F
C
a
P
H
"}
(88,1,1) = {"
U
f
f
y
y
i
i
X
X
m
m
W
W
R
R
n
d
K
r
D
F
C
a
P
H
"}
(89,1,1) = {"
U
f
f
y
y
i
i
X
X
m
m
W
W
R
R
n
d
K
r
D
F
C
a
P
H
"}
(90,1,1) = {"
U
f
f
y
y
i
i
X
X
m
m
W
W
R
R
n
d
K
r
D
F
C
a
P
H
"}
(91,1,1) = {"
U
f
f
y
y
i
i
X
X
m
m
W
W
R
R
n
d
K
r
D
F
C
a
P
H
"}
(92,1,1) = {"
U
f
f
y
y
i
i
X
X
m
m
W
W
R
R
n
d
K
r
D
F
C
a
P
H
"}
(93,1,1) = {"
U
f
f
y
y
i
i
X
X
m
m
W
W
R
R
n
d
K
r
D
F
C
a
P
H
"}
(94,1,1) = {"
U
f
f
y
y
i
i
X
X
m
m
W
W
R
R
n
d
K
r
D
F
C
a
P
H
"}
(95,1,1) = {"
U
f
f
y
y
i
i
X
X
m
m
W
W
R
R
n
d
K
r
D
F
C
a
P
H
"}
(96,1,1) = {"
U
f
f
y
y
i
i
X
X
m
m
W
W
R
R
n
d
K
r
D
F
C
a
P
H
"}
(97,1,1) = {"
U
f
f
y
y
i
i
X
X
m
m
W
W
R
R
n
d
K
r
D
F
C
a
P
H
"}
(98,1,1) = {"
U
f
f
y
y
i
i
X
X
m
m
W
W
R
R
n
d
K
r
D
F
C
a
P
H
"}
(99,1,1) = {"
U
f
f
y
y
i
i
X
X
m
m
W
W
R
R
n
d
K
r
D
F
C
a
P
H
"}
(100,1,1) = {"
U
f
f
y
y
i
i
X
X
m
m
W
W
R
R
n
d
K
r
D
F
C
a
P
H
"}
(101,1,1) = {"
U
f
f
y
y
i
i
X
X
m
m
W
W
R
R
n
d
K
r
D
F
C
a
P
H
"}
(102,1,1) = {"
U
f
f
y
y
i
i
X
X
m
m
W
W
R
R
n
d
K
r
D
F
C
a
P
H
"}
(103,1,1) = {"
U
f
f
y
y
i
i
X
X
m
m
W
W
R
R
n
d
K
r
D
F
C
a
P
H
"}
(104,1,1) = {"
U
f
f
y
y
i
i
X
X
m
m
W
W
R
R
n
d
K
r
D
F
C
a
P
H
"}
(105,1,1) = {"
U
f
f
y
y
i
i
X
X
m
m
W
W
R
R
n
d
K
r
D
F
C
a
P
H
"}
(106,1,1) = {"
U
f
f
y
y
i
i
X
X
m
m
W
W
R
R
n
d
K
r
D
F
C
a
P
H
"}
(107,1,1) = {"
U
f
f
y
y
i
i
X
X
m
m
W
W
R
R
n
d
K
r
D
F
C
a
P
H
"}
(108,1,1) = {"
U
f
f
y
y
i
i
X
X
m
m
W
W
R
R
n
d
K
r
D
F
C
a
P
H
"}
(109,1,1) = {"
U
f
f
y
y
i
i
X
X
m
m
W
W
R
R
n
d
K
r
D
F
C
a
P
H
"}
(110,1,1) = {"
U
f
f
y
y
i
i
X
X
m
m
W
W
R
R
n
d
K
r
D
F
C
a
P
H
"}
(111,1,1) = {"
U
f
f
y
y
i
i
X
X
m
m
W
W
R
R
n
d
K
r
D
F
C
a
P
H
"}
(112,1,1) = {"
U
f
f
y
y
i
i
X
X
m
m
W
W
R
R
n
d
K
r
D
F
C
a
P
H
"}
(113,1,1) = {"
U
f
f
y
y
i
i
X
X
m
m
W
W
R
R
n
d
K
r
D
F
C
a
P
H
"}
(114,1,1) = {"
U
f
f
y
y
i
i
X
X
m
m
W
W
R
R
n
d
K
r
D
F
C
a
P
H
"}
(115,1,1) = {"
U
f
f
y
y
i
i
X
X
m
m
W
W
R
R
n
d
K
r
D
F
C
a
P
H
"}
(116,1,1) = {"
U
f
f
y
y
i
i
X
X
m
m
W
W
R
R
n
d
K
r
D
F
C
a
P
H
"}
(117,1,1) = {"
U
f
f
y
y
i
i
X
X
m
m
W
W
R
R
n
d
K
r
D
F
C
a
P
H
"}
(118,1,1) = {"
U
f
f
y
y
i
i
X
X
m
m
W
W
R
R
n
d
K
r
D
F
C
a
P
H
"}
(119,1,1) = {"
U
f
f
y
y
i
i
X
X
m
m
W
W
R
R
n
d
K
r
D
F
C
a
P
H
"}
(120,1,1) = {"
U
f
f
y
y
i
i
X
X
m
m
W
W
R
R
n
d
K
r
D
F
C
a
P
H
"}
(121,1,1) = {"
U
f
f
y
y
i
i
X
X
m
m
W
W
R
R
n
d
K
r
D
F
C
a
P
H
"}
(122,1,1) = {"
U
f
f
y
y
i
i
X
X
m
m
W
W
R
R
n
d
K
r
D
F
C
a
P
H
"}
(123,1,1) = {"
U
f
f
y
y
i
i
X
X
m
m
W
W
R
R
n
d
K
r
D
F
C
a
P
H
"}
(124,1,1) = {"
U
f
f
y
y
i
i
X
X
m
m
W
W
R
R
n
d
K
r
D
F
C
a
P
H
"}
(125,1,1) = {"
U
f
f
y
y
i
i
X
X
m
m
W
W
R
R
n
d
K
r
D
F
C
a
P
H
"}
(126,1,1) = {"
U
f
f
y
y
i
i
X
X
m
m
W
W
R
R
n
d
K
r
D
F
C
a
P
H
"}
(127,1,1) = {"
U
f
f
y
y
i
i
X
X
m
m
W
W
R
R
n
d
K
r
D
F
C
a
P
H
"}
(128,1,1) = {"
U
f
f
y
y
i
i
X
X
m
m
W
W
R
R
n
d
K
r
D
F
C
a
P
H
"}
(129,1,1) = {"
U
f
f
y
y
i
i
X
X
m
m
W
W
R
R
n
d
K
r
D
F
C
a
P
H
"}
(130,1,1) = {"
U
f
f
y
y
i
i
X
X
m
m
W
W
R
R
n
d
K
r
D
F
C
a
P
H
"}
(131,1,1) = {"
U
f
f
y
y
i
i
X
X
m
m
W
W
R
R
n
d
K
r
D
F
C
a
P
H
"}
(132,1,1) = {"
U
f
f
y
y
i
i
X
X
m
m
W
W
R
R
n
d
K
r
D
F
C
a
P
H
"}
(133,1,1) = {"
U
f
f
y
y
i
i
X
X
m
m
W
W
R
R
n
d
K
r
D
F
C
a
P
H
"}
(134,1,1) = {"
U
f
f
y
y
i
i
X
X
m
m
W
W
R
R
n
d
K
r
D
F
C
a
P
H
"}
(135,1,1) = {"
U
f
f
y
y
i
i
X
X
m
m
W
W
R
R
n
d
K
r
D
F
C
a
P
H
"}
(136,1,1) = {"
U
f
f
y
y
i
i
X
X
m
m
W
W
R
R
n
d
K
r
D
F
C
a
P
H
"}
(137,1,1) = {"
U
f
f
y
y
i
i
X
X
m
m
W
W
R
R
n
d
K
r
D
F
C
a
P
H
"}
(138,1,1) = {"
U
f
f
y
y
i
i
X
X
m
m
W
W
R
R
n
d
K
r
D
F
C
a
P
H
"}
(139,1,1) = {"
U
f
f
y
y
i
i
X
X
m
m
W
W
R
R
n
d
K
r
D
F
C
a
P
H
"}
(140,1,1) = {"
U
f
f
y
y
i
i
X
X
m
m
W
W
R
R
n
d
K
r
D
F
C
a
P
H
"}
(141,1,1) = {"
U
f
f
y
y
i
i
X
X
m
m
W
W
R
R
n
d
K
r
D
F
C
a
P
H
"}
(142,1,1) = {"
U
f
f
y
y
i
i
X
X
m
m
W
W
R
R
n
d
K
r
D
F
C
a
P
H
"}
(143,1,1) = {"
U
f
f
y
y
i
i
X
X
m
m
W
W
R
R
n
d
K
r
D
F
C
a
P
H
"}
(144,1,1) = {"
U
f
f
y
y
i
i
X
X
m
m
W
W
R
R
n
d
K
r
D
F
C
a
P
H
"}
(145,1,1) = {"
U
f
f
y
y
i
i
X
X
m
m
W
W
R
R
n
d
K
r
D
F
C
a
P
H
"}
(146,1,1) = {"
U
f
f
y
y
i
i
X
X
m
m
W
W
R
R
n
d
K
r
D
F
C
a
P
H
"}
(147,1,1) = {"
U
f
f
y
y
i
i
X
X
m
m
W
W
R
R
n
d
K
r
D
F
C
a
P
H
"}
(148,1,1) = {"
U
f
f
y
y
i
i
X
X
m
m
W
W
R
R
n
d
K
r
D
F
C
a
P
H
"}
(149,1,1) = {"
U
f
f
y
y
i
i
X
X
m
m
W
W
R
R
n
d
K
r
D
F
C
a
P
H
"}
(150,1,1) = {"
U
f
f
y
y
i
i
X
X
m
m
W
W
R
R
n
d
K
r
D
F
C
a
P
H
"}
(151,1,1) = {"
U
f
f
y
y
i
i
X
X
m
m
W
W
R
R
n
d
K
r
D
F
C
a
P
H
"}
(152,1,1) = {"
U
f
f
y
y
i
i
X
X
m
m
W
W
R
R
n
d
K
r
D
F
C
a
P
H
"}
(153,1,1) = {"
U
f
f
y
y
i
i
X
X
m
m
W
W
R
R
n
d
K
r
D
F
C
a
P
H
"}
(154,1,1) = {"
U
f
f
y
y
i
i
X
X
m
m
W
W
R
R
n
d
K
r
D
F
C
a
P
H
"}
(155,1,1) = {"
U
f
f
y
y
i
i
X
X
m
m
W
W
R
R
n
d
K
r
D
F
C
a
P
H
"}
(156,1,1) = {"
U
f
f
y
y
i
i
X
X
m
m
W
W
R
R
n
d
K
r
D
F
C
a
P
H
"}
(157,1,1) = {"
U
f
f
y
y
i
i
X
X
m
m
W
W
R
R
n
d
K
r
D
F
C
a
P
H
"}
(158,1,1) = {"
U
f
f
y
y
i
i
X
X
m
m
W
W
R
R
n
d
K
r
D
F
C
a
P
H
"}
(159,1,1) = {"
U
f
f
y
y
i
i
X
X
m
m
W
W
R
R
n
d
K
r
D
F
C
a
P
H
"}
(160,1,1) = {"
U
f
f
y
y
i
i
X
X
m
m
W
W
R
R
n
d
K
r
D
F
C
a
P
H
"}
(161,1,1) = {"
U
f
f
y
y
i
i
X
X
m
m
W
W
R
R
n
d
K
r
D
F
C
a
P
H
"}
(162,1,1) = {"
U
f
f
y
y
i
i
X
X
m
m
W
W
R
R
n
d
K
r
D
F
C
a
P
H
"}
(163,1,1) = {"
U
f
f
y
y
i
i
X
X
m
m
W
W
R
R
n
d
K
r
D
F
C
a
P
H
"}
(164,1,1) = {"
U
f
f
y
y
i
i
X
X
m
m
W
W
R
R
n
d
K
r
D
F
C
a
P
H
"}
(165,1,1) = {"
U
f
f
y
y
i
i
X
X
m
m
W
W
R
R
n
d
K
r
D
F
C
a
P
H
"}
(166,1,1) = {"
U
f
f
y
y
i
i
X
X
m
m
W
W
R
R
n
d
K
r
D
F
C
a
P
H
"}
(167,1,1) = {"
U
f
f
y
y
i
i
X
X
m
m
W
W
R
R
n
d
K
r
D
F
C
a
P
H
"}
(168,1,1) = {"
U
f
f
y
y
i
i
X
X
m
m
W
W
R
R
n
d
K
r
D
F
C
a
P
H
"}
(169,1,1) = {"
U
f
f
y
y
i
i
X
X
m
m
W
W
R
R
n
d
K
r
D
F
C
a
P
H
"}
(170,1,1) = {"
U
f
f
y
y
i
i
X
X
m
m
W
W
R
R
n
d
K
r
D
F
C
a
P
H
"}
(171,1,1) = {"
U
f
f
y
y
i
i
X
X
m
m
W
W
R
R
n
d
K
r
D
F
C
a
P
H
"}
(172,1,1) = {"
U
f
f
y
y
i
i
X
X
m
m
W
W
R
R
n
d
K
r
D
F
C
a
P
H
"}
(173,1,1) = {"
U
f
f
y
y
i
i
X
X
m
m
W
W
R
R
n
d
K
r
D
F
C
a
P
H
"}
(174,1,1) = {"
U
f
f
y
y
i
i
X
X
m
m
W
W
R
R
n
d
K
r
D
F
C
a
P
H
"}
(175,1,1) = {"
U
f
f
y
y
i
i
X
X
m
m
W
W
R
R
n
d
K
r
D
F
C
a
P
H
"}
(176,1,1) = {"
U
f
f
y
y
i
i
X
X
m
m
W
W
R
R
n
d
K
r
D
F
C
a
P
H
"}
(177,1,1) = {"
U
f
f
y
y
i
i
X
X
m
m
W
W
R
R
n
d
K
r
D
F
C
a
P
H
"}
(178,1,1) = {"
U
f
f
y
y
i
i
X
X
m
m
W
W
R
R
n
d
K
r
D
F
C
a
P
H
"}
(179,1,1) = {"
U
f
f
y
y
i
i
X
X
m
m
W
W
R
R
n
d
K
r
D
F
C
a
P
H
"}
(180,1,1) = {"
U
f
f
y
y
i
i
X
X
m
m
W
W
R
R
n
d
K
r
D
F
C
a
P
H
"}
(181,1,1) = {"
U
f
f
y
y
i
i
X
X
m
m
W
W
R
R
n
d
K
r
D
F
C
a
P
H
"}
(182,1,1) = {"
U
f
f
y
y
i
i
X
X
m
m
W
W
R
R
n
d
K
r
D
F
C
a
P
H
"}
(183,1,1) = {"
U
f
f
y
y
i
i
X
X
m
m
W
W
R
R
n
d
K
r
D
F
C
a
P
H
"}
(184,1,1) = {"
U
f
f
y
y
i
i
X
X
m
m
W
W
R
R
n
d
K
r
D
F
C
a
P
H
"}
(185,1,1) = {"
U
f
f
y
y
i
i
X
X
m
m
W
W
R
R
n
d
K
r
D
F
C
a
P
H
"}
(186,1,1) = {"
U
f
f
y
y
i
i
X
X
m
m
W
W
R
R
n
d
K
r
D
F
C
a
P
H
"}
(187,1,1) = {"
U
f
f
y
y
i
i
X
X
m
m
W
W
R
R
n
d
K
r
D
F
C
a
P
H
"}
(188,1,1) = {"
U
f
f
y
y
i
i
X
X
m
m
W
W
R
R
n
d
K
r
D
F
C
a
P
H
"}
(189,1,1) = {"
U
f
f
y
y
i
i
X
X
m
m
W
W
R
R
n
d
K
r
D
F
C
a
P
H
"}
(190,1,1) = {"
U
f
f
y
y
i
i
X
X
m
m
W
W
R
R
n
d
K
r
D
F
C
a
P
H
"}
(191,1,1) = {"
U
f
f
y
y
i
i
X
X
m
m
W
W
R
R
n
d
K
r
D
F
C
a
P
H
"}
(192,1,1) = {"
U
f
f
y
y
i
i
X
X
m
m
W
W
R
R
n
d
K
r
D
F
C
a
P
H
"}
(193,1,1) = {"
U
f
f
y
y
i
i
X
X
m
m
W
W
R
R
n
d
K
r
D
F
C
a
P
H
"}
(194,1,1) = {"
U
f
f
y
y
i
i
X
X
m
m
W
W
R
R
n
d
K
r
D
F
C
a
P
H
"}
(195,1,1) = {"
U
f
f
y
y
i
i
X
X
m
m
W
W
R
R
n
d
K
r
D
F
C
a
P
H
"}
(196,1,1) = {"
U
f
f
y
y
i
i
X
X
m
m
W
W
R
R
n
d
K
r
D
F
C
a
P
H
"}
(197,1,1) = {"
U
f
f
y
y
i
i
X
X
m
m
W
W
R
R
n
d
K
r
D
F
C
a
P
H
"}
(198,1,1) = {"
U
f
f
y
y
i
i
X
X
m
m
W
W
R
R
n
d
K
r
D
F
C
a
P
H
"}
(199,1,1) = {"
U
f
f
y
y
i
i
X
X
m
m
W
W
R
R
n
d
K
r
D
F
C
a
P
H
"}
(200,1,1) = {"
U
f
f
y
y
i
i
X
X
m
m
W
W
R
R
n
d
K
r
D
F
C
a
P
H
"}
(201,1,1) = {"
U
f
f
y
y
i
i
X
X
m
m
W
W
R
R
n
d
K
r
D
F
C
a
P
H
"}
(202,1,1) = {"
U
f
f
y
y
i
i
X
X
m
m
W
W
R
R
n
d
K
r
D
F
C
a
P
H
"}
(203,1,1) = {"
U
f
f
y
y
i
i
X
X
m
m
W
W
R
R
n
d
K
r
D
F
C
a
P
H
"}
(204,1,1) = {"
U
f
f
y
y
i
i
X
X
m
m
W
W
R
R
n
d
K
r
D
F
C
a
P
H
"}
(205,1,1) = {"
U
f
f
y
y
i
i
X
X
m
m
W
W
R
R
n
d
K
r
D
F
C
a
P
H
"}
(206,1,1) = {"
U
f
f
y
y
i
i
X
X
m
m
W
W
R
R
n
d
K
r
D
F
C
a
P
H
"}
(207,1,1) = {"
U
f
f
y
y
i
i
X
X
m
m
W
W
R
R
n
d
K
r
D
F
C
a
P
H
"}
(208,1,1) = {"
U
f
f
y
y
i
i
X
X
m
m
W
W
R
R
n
d
K
r
D
F
C
a
P
H
"}
(209,1,1) = {"
U
f
f
y
y
i
i
X
X
m
m
W
W
R
R
n
d
K
r
D
F
C
a
P
H
"}
(210,1,1) = {"
U
f
f
y
y
i
i
X
X
m
m
W
W
R
R
n
d
K
r
D
F
C
a
P
H
"}
(211,1,1) = {"
U
f
f
y
y
i
i
X
X
m
m
W
W
R
R
n
d
K
r
D
F
C
a
P
H
"}
(212,1,1) = {"
U
f
f
y
y
i
i
X
X
m
m
W
W
R
R
n
d
K
r
D
F
C
a
P
H
"}
(213,1,1) = {"
U
f
f
y
y
i
i
X
X
m
m
W
W
R
R
n
d
K
r
D
F
C
a
P
H
"}
(214,1,1) = {"
U
f
f
y
y
i
i
X
X
m
m
W
W
R
R
n
d
K
r
D
F
C
a
P
H
"}
(215,1,1) = {"
U
f
f
y
y
i
i
X
X
m
m
W
W
R
R
n
d
K
r
D
F
C
a
P
H
"}
(216,1,1) = {"
U
f
f
y
y
i
i
X
X
m
m
W
W
R
R
n
d
K
r
D
F
C
a
P
H
"}
(217,1,1) = {"
U
f
f
y
y
i
i
X
X
m
m
W
W
R
R
n
d
K
r
D
F
C
a
P
H
"}
(218,1,1) = {"
U
f
f
y
y
i
i
X
X
m
m
W
W
R
R
n
d
K
r
D
F
C
a
P
H
"}
(219,1,1) = {"
U
f
f
y
y
i
i
X
X
m
m
W
W
R
R
n
d
K
r
D
F
C
a
P
H
"}
(220,1,1) = {"
U
f
f
y
y
i
i
X
X
m
m
W
W
R
R
n
d
K
r
D
F
C
a
P
H
"}
(221,1,1) = {"
U
f
f
y
y
i
i
X
X
m
m
W
W
R
R
n
d
K
r
D
F
C
a
P
H
"}
(222,1,1) = {"
U
f
f
y
y
i
i
X
X
m
m
W
W
R
R
n
d
K
r
D
F
C
a
P
H
"}
(223,1,1) = {"
U
f
f
y
y
i
i
X
X
m
m
W
W
R
R
n
d
K
r
D
F
C
a
P
H
"}
(224,1,1) = {"
U
f
f
y
y
i
i
X
X
m
m
W
W
R
R
n
d
K
r
D
F
C
a
P
H
"}
(225,1,1) = {"
U
f
f
y
y
i
i
X
X
m
m
W
W
R
R
n
d
K
r
D
F
C
a
P
H
"}
(226,1,1) = {"
U
f
f
y
y
i
i
X
X
m
m
W
W
R
R
n
d
K
r
D
F
C
a
P
H
"}
(227,1,1) = {"
U
f
f
y
y
i
i
X
X
m
m
W
W
R
R
n
d
K
r
D
F
C
a
P
H
"}
(228,1,1) = {"
U
f
f
y
y
i
i
X
X
m
m
W
W
R
R
n
d
K
r
D
F
C
a
P
H
"}
(229,1,1) = {"
U
f
f
y
y
i
i
X
X
m
m
W
W
R
R
n
d
K
r
D
F
C
a
P
H
"}
(230,1,1) = {"
U
f
f
y
y
i
i
X
X
m
m
W
W
R
R
n
d
K
r
D
F
C
a
P
H
"}
(231,1,1) = {"
U
f
f
y
y
i
i
X
X
m
m
W
W
R
R
n
d
K
r
D
F
C
a
P
H
"}
(232,1,1) = {"
U
f
f
y
y
i
i
X
X
m
m
W
W
R
R
n
d
K
r
D
F
C
a
P
H
"}
(233,1,1) = {"
U
f
f
y
y
i
i
X
X
m
m
W
W
R
R
n
d
K
r
D
F
C
a
P
H
"}
(234,1,1) = {"
U
f
f
y
y
i
i
X
X
m
m
W
W
R
R
n
d
K
r
D
F
C
a
P
H
"}
(235,1,1) = {"
U
f
f
y
y
i
i
X
X
m
m
W
W
R
R
n
d
K
r
D
F
C
a
P
H
"}
(236,1,1) = {"
U
f
f
y
y
i
i
X
X
m
m
W
W
R
R
n
d
K
r
D
F
C
a
P
H
"}
(237,1,1) = {"
U
f
f
y
y
i
i
X
X
m
m
W
W
R
R
n
d
K
r
D
F
C
a
P
H
"}
(238,1,1) = {"
U
f
f
y
y
i
i
X
X
m
m
W
W
R
R
n
d
K
r
D
F
C
a
P
H
"}
(239,1,1) = {"
U
f
f
y
y
i
i
X
X
m
m
W
W
R
R
n
d
K
r
D
F
C
a
P
H
"}
(240,1,1) = {"
U
f
f
y
y
i
i
X
X
m
m
W
W
R
R
n
d
K
r
D
F
C
a
P
H
"}
(241,1,1) = {"
U
f
f
y
y
i
i
X
X
m
m
W
W
R
R
n
d
K
r
D
F
C
a
P
H
"}
(242,1,1) = {"
U
f
f
y
y
i
i
X
X
m
m
W
W
R
R
n
d
K
r
D
F
C
a
P
H
"}
(243,1,1) = {"
U
f
f
y
y
i
i
X
X
m
m
W
W
R
R
n
d
K
r
D
F
C
a
P
H
"}
(244,1,1) = {"
U
f
f
y
y
i
i
X
X
m
m
W
W
R
R
n
d
K
r
D
F
C
a
P
H
"}
(245,1,1) = {"
U
f
f
y
y
i
i
X
X
m
m
W
W
R
R
n
d
K
r
D
F
C
a
P
H
"}
(246,1,1) = {"
U
f
f
y
y
i
i
X
X
m
m
W
W
R
R
n
d
K
r
D
F
C
a
P
H
"}
(247,1,1) = {"
U
f
f
y
y
i
i
X
X
m
m
W
W
R
R
n
d
K
r
D
F
C
a
P
H
"}
(248,1,1) = {"
U
f
f
y
y
i
i
X
X
m
m
W
W
R
R
n
d
K
r
D
F
C
a
P
H
"}
(249,1,1) = {"
U
f
f
y
y
i
i
X
X
m
m
W
W
R
R
n
d
K
r
D
F
C
a
P
H
"}
(250,1,1) = {"
U
f
f
y
y
i
i
X
X
m
m
W
W
R
R
n
d
K
r
D
F
C
a
P
H
"}
(251,1,1) = {"
U
f
f
y
y
i
i
X
X
m
m
W
W
R
R
n
d
K
r
D
F
C
a
P
H
"}
(252,1,1) = {"
U
f
f
y
y
i
i
X
X
m
m
W
W
R
R
n
d
K
r
D
F
C
a
P
H
"}
(253,1,1) = {"
U
f
f
y
y
i
i
X
X
m
m
W
W
R
R
q
d
K
E
v
F
C
a
P
H
"}
(254,1,1) = {"
U
f
f
y
y
i
i
X
X
m
m
W
W
R
R
q
M
K
l
D
g
C
o
t
H
"}
(255,1,1) = {"
U
f
f
y
y
i
i
X
X
m
m
W
W
R
R
n
d
j
r
c
F
G
a
P
H
"}
