//MAP CONVERTED BY dmm2tgm.py THIS HEADER COMMENT PREVENTS RECONVERSION, DO NOT REMOVE
"a" = (
/turf/closed/indestructible/rock,
/area/trainstation/indoors/station)
"f" = (
/turf/open/misc/dirt/dark/station,
/area/trainstation/indoors/station)

(1,1,1) = {"
a
a
a
f
f
f
"}
(2,1,1) = {"
a
a
a
f
f
f
"}
(3,1,1) = {"
a
a
a
f
f
f
"}
(4,1,1) = {"
a
a
a
f
f
f
"}
(5,1,1) = {"
a
a
a
f
f
f
"}
(6,1,1) = {"
a
a
a
f
f
f
"}
(7,1,1) = {"
a
a
a
f
f
f
"}
(8,1,1) = {"
a
a
a
f
f
f
"}
(9,1,1) = {"
a
a
a
f
f
f
"}
(10,1,1) = {"
a
a
a
f
f
f
"}
(11,1,1) = {"
a
a
a
f
f
f
"}
(12,1,1) = {"
a
a
a
f
f
f
"}
(13,1,1) = {"
a
a
a
f
f
f
"}
(14,1,1) = {"
a
a
a
f
f
f
"}
(15,1,1) = {"
a
a
a
f
f
f
"}
(16,1,1) = {"
a
a
a
f
f
f
"}
(17,1,1) = {"
a
a
a
f
f
f
"}
(18,1,1) = {"
a
a
a
f
f
f
"}
(19,1,1) = {"
a
a
a
f
f
f
"}
(20,1,1) = {"
a
a
a
f
f
f
"}
(21,1,1) = {"
a
a
a
f
f
f
"}
(22,1,1) = {"
a
a
a
f
f
f
"}
(23,1,1) = {"
a
a
a
f
f
f
"}
(24,1,1) = {"
a
a
a
f
f
f
"}
(25,1,1) = {"
a
a
a
f
f
f
"}
(26,1,1) = {"
a
a
a
f
f
f
"}
(27,1,1) = {"
a
a
a
f
f
f
"}
(28,1,1) = {"
a
a
a
f
f
f
"}
(29,1,1) = {"
a
a
a
f
f
f
"}
(30,1,1) = {"
a
a
a
f
f
f
"}
(31,1,1) = {"
a
a
a
f
f
f
"}
(32,1,1) = {"
a
a
a
f
f
f
"}
(33,1,1) = {"
a
a
a
f
f
f
"}
(34,1,1) = {"
a
a
a
f
f
f
"}
(35,1,1) = {"
a
a
a
f
f
f
"}
(36,1,1) = {"
a
a
a
f
f
f
"}
(37,1,1) = {"
a
a
a
f
f
f
"}
(38,1,1) = {"
a
a
a
f
f
f
"}
(39,1,1) = {"
a
a
a
f
f
f
"}
(40,1,1) = {"
a
a
a
f
f
f
"}
(41,1,1) = {"
a
a
a
f
f
f
"}
(42,1,1) = {"
a
a
a
f
f
f
"}
(43,1,1) = {"
a
a
a
f
f
f
"}
(44,1,1) = {"
a
a
a
f
f
f
"}
(45,1,1) = {"
a
a
a
f
f
f
"}
(46,1,1) = {"
a
a
a
f
f
f
"}
(47,1,1) = {"
a
a
a
f
f
f
"}
(48,1,1) = {"
a
a
a
f
f
f
"}
(49,1,1) = {"
a
a
a
f
f
f
"}
(50,1,1) = {"
a
a
a
f
f
f
"}
(51,1,1) = {"
a
a
a
f
f
f
"}
(52,1,1) = {"
a
a
a
f
f
f
"}
(53,1,1) = {"
a
a
a
f
f
f
"}
(54,1,1) = {"
a
a
a
f
f
f
"}
(55,1,1) = {"
a
a
a
f
f
f
"}
(56,1,1) = {"
a
a
a
f
f
f
"}
(57,1,1) = {"
a
a
a
f
f
f
"}
(58,1,1) = {"
a
a
a
f
f
f
"}
(59,1,1) = {"
a
a
a
f
f
f
"}
(60,1,1) = {"
a
a
a
f
f
f
"}
(61,1,1) = {"
a
a
a
f
f
f
"}
(62,1,1) = {"
a
a
a
f
f
f
"}
(63,1,1) = {"
a
a
a
f
f
f
"}
(64,1,1) = {"
a
a
a
f
f
f
"}
(65,1,1) = {"
a
a
a
f
f
f
"}
(66,1,1) = {"
a
a
a
f
f
f
"}
(67,1,1) = {"
a
a
a
f
f
f
"}
(68,1,1) = {"
a
a
a
f
f
f
"}
(69,1,1) = {"
a
a
a
f
f
f
"}
(70,1,1) = {"
a
a
a
f
f
f
"}
(71,1,1) = {"
a
a
a
f
f
f
"}
(72,1,1) = {"
a
a
a
f
f
f
"}
(73,1,1) = {"
a
a
a
f
f
f
"}
(74,1,1) = {"
a
a
a
f
f
f
"}
(75,1,1) = {"
a
a
a
f
f
f
"}
(76,1,1) = {"
a
a
a
f
f
f
"}
(77,1,1) = {"
a
a
a
f
f
f
"}
(78,1,1) = {"
a
a
a
f
f
f
"}
(79,1,1) = {"
a
a
a
f
f
f
"}
(80,1,1) = {"
a
a
a
f
f
f
"}
(81,1,1) = {"
a
a
a
f
f
f
"}
(82,1,1) = {"
a
a
a
f
f
f
"}
(83,1,1) = {"
a
a
a
f
f
f
"}
(84,1,1) = {"
a
a
a
f
f
f
"}
(85,1,1) = {"
a
a
a
f
f
f
"}
(86,1,1) = {"
a
a
a
f
f
f
"}
(87,1,1) = {"
a
a
a
f
f
f
"}
(88,1,1) = {"
a
a
a
f
f
f
"}
(89,1,1) = {"
a
a
a
f
f
f
"}
(90,1,1) = {"
a
a
a
f
f
f
"}
(91,1,1) = {"
a
a
a
f
f
f
"}
(92,1,1) = {"
a
a
a
f
f
f
"}
(93,1,1) = {"
a
a
a
f
f
f
"}
(94,1,1) = {"
a
a
a
f
f
f
"}
(95,1,1) = {"
a
a
a
f
f
f
"}
(96,1,1) = {"
a
a
a
f
f
f
"}
(97,1,1) = {"
a
a
a
f
f
f
"}
(98,1,1) = {"
a
a
a
f
f
f
"}
(99,1,1) = {"
a
a
a
f
f
f
"}
(100,1,1) = {"
a
a
a
f
f
f
"}
(101,1,1) = {"
a
a
a
f
f
f
"}
(102,1,1) = {"
a
a
a
f
f
f
"}
(103,1,1) = {"
a
a
a
f
f
f
"}
(104,1,1) = {"
a
a
a
f
f
f
"}
(105,1,1) = {"
a
a
a
f
f
f
"}
(106,1,1) = {"
a
a
a
f
f
f
"}
(107,1,1) = {"
a
a
a
f
f
f
"}
(108,1,1) = {"
a
a
a
f
f
f
"}
(109,1,1) = {"
a
a
a
f
f
f
"}
(110,1,1) = {"
a
a
a
f
f
f
"}
(111,1,1) = {"
a
a
a
f
f
f
"}
(112,1,1) = {"
a
a
a
f
f
f
"}
(113,1,1) = {"
a
a
a
f
f
f
"}
(114,1,1) = {"
a
a
a
f
f
f
"}
(115,1,1) = {"
a
a
a
f
f
f
"}
(116,1,1) = {"
a
a
a
f
f
f
"}
(117,1,1) = {"
a
a
a
f
f
f
"}
(118,1,1) = {"
a
a
a
f
f
f
"}
(119,1,1) = {"
a
a
a
f
f
f
"}
(120,1,1) = {"
a
a
a
f
f
f
"}
(121,1,1) = {"
a
a
a
f
f
f
"}
(122,1,1) = {"
a
a
a
f
f
f
"}
(123,1,1) = {"
a
a
a
f
f
f
"}
(124,1,1) = {"
a
a
a
f
f
f
"}
(125,1,1) = {"
a
a
a
f
f
f
"}
(126,1,1) = {"
a
a
a
f
f
f
"}
(127,1,1) = {"
a
a
a
f
f
f
"}
(128,1,1) = {"
a
a
a
f
f
f
"}
(129,1,1) = {"
a
a
a
f
f
f
"}
(130,1,1) = {"
a
a
a
f
f
f
"}
(131,1,1) = {"
a
a
a
f
f
f
"}
(132,1,1) = {"
a
a
a
f
f
f
"}
(133,1,1) = {"
a
a
a
f
f
f
"}
(134,1,1) = {"
a
a
a
f
f
f
"}
(135,1,1) = {"
a
a
a
f
f
f
"}
(136,1,1) = {"
a
a
a
f
f
f
"}
(137,1,1) = {"
a
a
a
f
f
f
"}
(138,1,1) = {"
a
a
a
f
f
f
"}
(139,1,1) = {"
a
a
a
f
f
f
"}
(140,1,1) = {"
a
a
a
f
f
f
"}
(141,1,1) = {"
a
a
a
f
f
f
"}
(142,1,1) = {"
a
a
a
f
f
f
"}
(143,1,1) = {"
a
a
a
f
f
f
"}
(144,1,1) = {"
a
a
a
f
f
f
"}
(145,1,1) = {"
a
a
a
f
f
f
"}
(146,1,1) = {"
a
a
a
f
f
f
"}
(147,1,1) = {"
a
a
a
f
f
f
"}
(148,1,1) = {"
a
a
a
f
f
f
"}
(149,1,1) = {"
a
a
a
f
f
f
"}
(150,1,1) = {"
a
a
a
f
f
f
"}
(151,1,1) = {"
a
a
a
f
f
f
"}
(152,1,1) = {"
a
a
a
f
f
f
"}
(153,1,1) = {"
a
a
a
f
f
f
"}
(154,1,1) = {"
a
a
a
f
f
f
"}
(155,1,1) = {"
a
a
a
f
f
f
"}
(156,1,1) = {"
a
a
a
f
f
f
"}
(157,1,1) = {"
a
a
a
f
f
f
"}
(158,1,1) = {"
a
a
a
f
f
f
"}
(159,1,1) = {"
a
a
a
f
f
f
"}
(160,1,1) = {"
a
a
a
f
f
f
"}
(161,1,1) = {"
a
a
a
f
f
f
"}
(162,1,1) = {"
a
a
a
f
f
f
"}
(163,1,1) = {"
a
a
a
f
f
f
"}
(164,1,1) = {"
a
a
a
f
f
f
"}
(165,1,1) = {"
a
a
a
f
f
f
"}
(166,1,1) = {"
a
a
a
f
f
f
"}
(167,1,1) = {"
a
a
a
f
f
f
"}
(168,1,1) = {"
a
a
a
f
f
f
"}
(169,1,1) = {"
a
a
a
f
f
f
"}
(170,1,1) = {"
a
a
a
f
f
f
"}
(171,1,1) = {"
a
a
a
f
f
f
"}
(172,1,1) = {"
a
a
a
f
f
f
"}
(173,1,1) = {"
a
a
a
f
f
f
"}
(174,1,1) = {"
a
a
a
f
f
f
"}
(175,1,1) = {"
a
a
a
f
f
f
"}
(176,1,1) = {"
a
a
a
f
f
f
"}
(177,1,1) = {"
a
a
a
f
f
f
"}
(178,1,1) = {"
a
a
a
f
f
f
"}
(179,1,1) = {"
a
a
a
f
f
f
"}
(180,1,1) = {"
a
a
a
f
f
f
"}
(181,1,1) = {"
a
a
a
f
f
f
"}
(182,1,1) = {"
a
a
a
f
f
f
"}
(183,1,1) = {"
a
a
a
f
f
f
"}
(184,1,1) = {"
a
a
a
f
f
f
"}
(185,1,1) = {"
a
a
a
f
f
f
"}
(186,1,1) = {"
a
a
a
f
f
f
"}
(187,1,1) = {"
a
a
a
f
f
f
"}
(188,1,1) = {"
a
a
a
f
f
f
"}
(189,1,1) = {"
a
a
a
f
f
f
"}
(190,1,1) = {"
a
a
a
f
f
f
"}
(191,1,1) = {"
a
a
a
f
f
f
"}
(192,1,1) = {"
a
a
a
f
f
f
"}
(193,1,1) = {"
a
a
a
f
f
f
"}
(194,1,1) = {"
a
a
a
f
f
f
"}
(195,1,1) = {"
a
a
a
f
f
f
"}
(196,1,1) = {"
a
a
a
f
f
f
"}
(197,1,1) = {"
a
a
a
f
f
f
"}
(198,1,1) = {"
a
a
a
f
f
f
"}
(199,1,1) = {"
a
a
a
f
f
f
"}
(200,1,1) = {"
a
a
a
f
f
f
"}
(201,1,1) = {"
a
a
a
f
f
f
"}
(202,1,1) = {"
a
a
a
f
f
f
"}
(203,1,1) = {"
a
a
a
f
f
f
"}
(204,1,1) = {"
a
a
a
f
f
f
"}
(205,1,1) = {"
a
a
a
f
f
f
"}
(206,1,1) = {"
a
a
a
f
f
f
"}
(207,1,1) = {"
a
a
a
f
f
f
"}
(208,1,1) = {"
a
a
a
f
f
f
"}
(209,1,1) = {"
a
a
a
f
f
f
"}
(210,1,1) = {"
a
a
a
f
f
f
"}
(211,1,1) = {"
a
a
a
f
f
f
"}
(212,1,1) = {"
a
a
a
f
f
f
"}
(213,1,1) = {"
a
a
a
f
f
f
"}
(214,1,1) = {"
a
a
a
f
f
f
"}
(215,1,1) = {"
a
a
a
f
f
f
"}
(216,1,1) = {"
a
a
a
f
f
f
"}
(217,1,1) = {"
a
a
a
f
f
f
"}
(218,1,1) = {"
a
a
a
f
f
f
"}
(219,1,1) = {"
a
a
a
f
f
f
"}
(220,1,1) = {"
a
a
a
f
f
f
"}
(221,1,1) = {"
a
a
a
f
f
f
"}
(222,1,1) = {"
a
a
a
f
f
f
"}
(223,1,1) = {"
a
a
a
f
f
f
"}
(224,1,1) = {"
a
a
a
f
f
f
"}
(225,1,1) = {"
a
a
a
f
f
f
"}
(226,1,1) = {"
a
a
a
f
f
f
"}
(227,1,1) = {"
a
a
a
f
f
f
"}
(228,1,1) = {"
a
a
a
f
f
f
"}
(229,1,1) = {"
a
a
a
f
f
f
"}
(230,1,1) = {"
a
a
a
f
f
f
"}
(231,1,1) = {"
a
a
a
f
f
f
"}
(232,1,1) = {"
a
a
a
f
f
f
"}
(233,1,1) = {"
a
a
a
f
f
f
"}
(234,1,1) = {"
a
a
a
f
f
f
"}
(235,1,1) = {"
a
a
a
f
f
f
"}
(236,1,1) = {"
a
a
a
f
f
f
"}
(237,1,1) = {"
a
a
a
f
f
f
"}
(238,1,1) = {"
a
a
a
f
f
f
"}
(239,1,1) = {"
a
a
a
f
f
f
"}
(240,1,1) = {"
a
a
a
f
f
f
"}
(241,1,1) = {"
a
a
a
f
f
f
"}
(242,1,1) = {"
a
a
a
f
f
f
"}
(243,1,1) = {"
a
a
a
f
f
f
"}
(244,1,1) = {"
a
a
a
f
f
f
"}
(245,1,1) = {"
a
a
a
f
f
f
"}
(246,1,1) = {"
a
a
a
f
f
f
"}
(247,1,1) = {"
a
a
a
f
f
f
"}
(248,1,1) = {"
a
a
a
f
f
f
"}
(249,1,1) = {"
a
a
a
f
f
f
"}
(250,1,1) = {"
a
a
a
f
f
f
"}
(251,1,1) = {"
a
a
a
f
f
f
"}
(252,1,1) = {"
a
a
a
f
f
f
"}
(253,1,1) = {"
a
a
a
f
f
f
"}
(254,1,1) = {"
a
a
a
f
f
f
"}
(255,1,1) = {"
a
a
a
f
f
f
"}
