//MAP CONVERTED BY dmm2tgm.py THIS HEADER COMMENT PREVENTS RECONVERSION, DO NOT REMOVE
"a" = (
/obj/structure/chair/office/light{
	dir = 8
	},
/obj/effect/landmark/start/security_medic,
/turf/open/floor/iron/white,
/area/station/security/medical)
"b" = (
/obj/machinery/door/airlock/maintenance_hatch,
/obj/effect/mapping_helpers/airlock/access/all/security/brig,
/obj/effect/mapping_helpers/airlock/autoname,
/obj/structure/cable,
/obj/machinery/atmospherics/pipe/smart/manifold4w/scrubbers/hidden/layer2,
/obj/machinery/atmospherics/pipe/smart/manifold4w/supply/hidden/layer4,
/turf/open/floor/plating,
/area/station/security/medical)
"c" = (
/obj/machinery/atmospherics/pipe/smart/manifold4w/scrubbers/hidden/layer2,
/obj/machinery/atmospherics/pipe/smart/manifold4w/supply/hidden/layer4,
/obj/structure/cable,
/obj/structure/disposalpipe/segment{
	dir = 4
	},
/obj/effect/turf_decal/trimline/blue/filled/corner{
	dir = 4
	},
/turf/open/floor/iron/white,
/area/station/security/medical)
"d" = (
/obj/effect/turf_decal/trimline/blue/filled/line{
	dir = 6
	},
/obj/machinery/computer/operating{
	dir = 1
	},
/obj/machinery/vitals_reader/directional/south,
/turf/open/floor/iron/white,
/area/station/security/medical)
"e" = (
/obj/structure/disposalpipe/segment{
	dir = 4
	},
/obj/effect/turf_decal/trimline/blue/filled/corner{
	dir = 1
	},
/obj/effect/turf_decal/trimline/blue/filled/corner{
	dir = 8
	},
/turf/open/floor/iron/white,
/area/station/security/medical)
"f" = (
/obj/machinery/atmospherics/components/unary/vent_scrubber/on/layer2{
	dir = 1
	},
/turf/open/floor/iron/white,
/area/station/security/medical)
"g" = (
/obj/effect/turf_decal/trimline/blue/filled/line{
	dir = 4
	},
/turf/open/floor/iron/white,
/area/station/security/medical)
"i" = (
/obj/structure/table/reinforced/ctf,
/obj/item/reagent_containers/cup/bottle/multiver{
	pixel_x = -6;
	pixel_y = 9
	},
/obj/item/reagent_containers/syringe{
	pixel_x = -6;
	pixel_y = -1
	},
/obj/item/reagent_containers/spray/cleaner{
	pixel_x = 12;
	pixel_y = 16
	},
/obj/item/reagent_containers/cup/bottle/formaldehyde{
	pixel_x = -2;
	pixel_y = 9
	},
/obj/item/reagent_containers/cup/bottle/epinephrine{
	pixel_x = 2;
	pixel_y = 9
	},
/obj/item/storage/box/bandages{
	pixel_y = -12;
	pixel_x = 5
	},
/obj/item/book/manual/wiki/security_space_law{
	pixel_y = -12;
	pixel_x = -8
	},
/obj/item/reagent_containers/cup/glass/mug/nanotrasen{
	pixel_x = 12;
	pixel_y = 2
	},
/obj/structure/sign/poster/official/moth_epi/directional/north,
/obj/machinery/wall_healer/directional/west,
/obj/effect/turf_decal/trimline/blue/filled/line{
	dir = 9
	},
/obj/machinery/light/directional/west,
/turf/open/floor/iron/white,
/area/station/security/medical)
"j" = (
/obj/machinery/stasis{
	dir = 4
	},
/obj/machinery/iv_drip,
/obj/item/bedsheet/medical{
	dir = 4
	},
/obj/effect/turf_decal/trimline/blue/filled/line{
	dir = 8
	},
/turf/open/floor/iron/white,
/area/station/security/medical)
"n" = (
/obj/structure/table/reinforced/ctf,
/obj/item/paper_bin{
	pixel_x = 10;
	pixel_y = 8
	},
/obj/item/pen{
	pixel_x = 11;
	pixel_y = 10
	},
/obj/item/folder/red{
	pixel_x = -10;
	pixel_y = 7
	},
/obj/item/folder/white{
	pixel_x = -5;
	pixel_y = 7
	},
/obj/effect/turf_decal/trimline/blue/filled/line{
	dir = 1
	},
/turf/open/floor/iron/white,
/area/station/security/medical)
"o" = (
/turf/template_noop,
/area/template_noop)
"q" = (
/obj/structure/cable,
/obj/machinery/atmospherics/pipe/smart/manifold4w/scrubbers/hidden/layer2,
/obj/machinery/atmospherics/pipe/smart/manifold4w/supply/hidden/layer4,
/obj/structure/disposalpipe/segment{
	dir = 10
	},
/obj/effect/turf_decal/trimline/blue/filled/line{
	dir = 5
	},
/turf/open/floor/iron/white,
/area/station/security/medical)
"r" = (
/obj/effect/turf_decal/trimline/blue/filled/corner,
/obj/effect/turf_decal/tile/blue{
	dir = 1
	},
/turf/open/floor/iron/white,
/area/station/security/medical)
"s" = (
/obj/machinery/power/apc/auto_name/directional/south,
/obj/structure/cable,
/obj/structure/table/reinforced/rglass,
/obj/machinery/wall_healer/directional/west,
/obj/effect/turf_decal/trimline/blue/filled/line{
	dir = 10
	},
/obj/machinery/light/directional/west,
/obj/item/surgery_tray/full,
/turf/open/floor/iron/white,
/area/station/security/medical)
"w" = (
/obj/effect/mapping_helpers/requests_console/supplies,
/obj/effect/mapping_helpers/requests_console/assistance,
/obj/effect/mapping_helpers/requests_console/information,
/obj/machinery/requests_console/auto_name/directional/south,
/obj/structure/closet/secure_closet/security_medic,
/obj/item/clothing/head/helmet/toggleable/justice/escape,
/obj/item/reagent_containers/blood/o_minus{
	pixel_x = 0;
	pixel_y = 0
	},
/obj/item/reagent_containers/blood/o_minus{
	pixel_x = 0;
	pixel_y = 0
	},
/obj/item/reagent_containers/blood/lizard{
	pixel_x = 0;
	pixel_y = 0
	},
/obj/item/paper/fluff/jobs/medical/blood_types{
	pixel_x = 0;
	pixel_y = 0
	},
/obj/structure/extinguisher_cabinet/directional/east,
/obj/effect/turf_decal/trimline/blue/filled/line{
	dir = 6
	},
/turf/open/floor/iron/white,
/area/station/security/medical)
"z" = (
/turf/closed/wall/r_wall,
/area/station/security/medical)
"A" = (
/obj/structure/table/reinforced/ctf,
/obj/machinery/computer/records/medical/laptop{
	dir = 4;
	pixel_x = 3;
	pixel_y = 3
	},
/obj/effect/turf_decal/trimline/blue/filled/line{
	dir = 8
	},
/turf/open/floor/iron/white,
/area/station/security/medical)
"B" = (
/obj/structure/cable,
/obj/structure/table/optable,
/obj/machinery/defibrillator_mount/directional/south,
/obj/effect/turf_decal/trimline/blue/filled/line,
/turf/open/floor/iron/white,
/area/station/security/medical)
"C" = (
/turf/closed/wall/r_wall,
/area/station/maintenance/starboard/fore)
"D" = (
/obj/structure/cable,
/obj/effect/turf_decal/tile/blue,
/obj/effect/turf_decal/tile/blue{
	dir = 4
	},
/obj/effect/turf_decal/tile/blue{
	dir = 1
	},
/obj/effect/landmark/start/security_medic,
/turf/open/floor/iron/white,
/area/station/security/medical)
"E" = (
/obj/machinery/door/airlock/security/glass{
	name = "Security Equipment Room"
	},
/obj/machinery/door/firedoor,
/obj/effect/mapping_helpers/airlock/access/any/medical/general,
/obj/effect/mapping_helpers/airlock/access/any/security/general,
/obj/structure/disposalpipe/segment{
	dir = 4
	},
/obj/effect/landmark/navigate_destination/autoname,
/turf/open/floor/iron/dark,
/area/station/security/medical)
"G" = (
/obj/machinery/atmospherics/components/unary/vent_pump/on/layer4,
/obj/effect/turf_decal/trimline/blue/filled/line{
	dir = 4
	},
/turf/open/floor/iron/white,
/area/station/security/medical)
"I" = (
/obj/machinery/firealarm/directional/west,
/obj/structure/table/reinforced/ctf,
/obj/item/storage/medkit/regular{
	pixel_x = -3;
	pixel_y = 17
	},
/obj/item/healthanalyzer{
	pixel_y = 6;
	pixel_x = 3
	},
/obj/item/storage/box/bodybags{
	pixel_y = 1;
	pixel_x = -6
	},
/obj/effect/turf_decal/trimline/blue/filled/line{
	dir = 8
	},
/turf/open/floor/iron/white,
/area/station/security/medical)
"J" = (
/obj/structure/window/reinforced/spawner/directional/south,
/obj/effect/turf_decal/trimline/red/real_red/end,
/obj/effect/turf_decal/siding/dark/end,
/obj/structure/bodycontainer/morgue{
	dir = 1
	},
/obj/effect/turf_decal/tile/neutral/half/contrasted{
	dir = 8
	},
/obj/item/radio/intercom/directional/east,
/turf/open/floor/iron/dark,
/area/station/security/medical)
"K" = (
/turf/closed/wall,
/area/station/security/medical)
"L" = (
/obj/structure/curtain/bounty,
/obj/effect/spawner/structure/window/reinforced,
/turf/open/floor/plating,
/area/station/security/medical)
"M" = (
/obj/structure/cable,
/obj/machinery/holopad,
/obj/structure/disposalpipe/segment{
	dir = 4
	},
/turf/open/floor/iron/white,
/area/station/security/medical)
"O" = (
/obj/machinery/camera/autoname/security/directional/east,
/obj/machinery/firealarm/directional/east,
/obj/structure/disposalpipe/trunk{
	dir = 1
	},
/obj/machinery/disposal/bin,
/obj/effect/turf_decal/trimline/blue/filled/line{
	dir = 4
	},
/turf/open/floor/iron/white,
/area/station/security/medical)
"P" = (
/obj/effect/turf_decal/trimline/red/real_red/end{
	dir = 1
	},
/obj/effect/turf_decal/siding/dark/end{
	dir = 1
	},
/obj/structure/sign/poster/official/cleanliness/directional/east,
/obj/structure/sink/directional/west,
/obj/effect/turf_decal/tile/neutral/half/contrasted{
	dir = 8
	},
/turf/open/floor/iron/dark,
/area/station/security/medical)
"Q" = (
/turf/open/floor/iron/white,
/area/station/security/medical)
"S" = (
/obj/structure/table/reinforced/ctf,
/obj/machinery/computer/crew,
/obj/machinery/airalarm/directional/east,
/obj/effect/turf_decal/trimline/blue/filled/line{
	dir = 5
	},
/turf/open/floor/iron/white,
/area/station/security/medical)
"V" = (
/obj/machinery/light_switch/directional/west,
/obj/machinery/stasis{
	dir = 4
	},
/obj/machinery/iv_drip,
/obj/item/bedsheet/medical{
	dir = 4
	},
/obj/effect/turf_decal/trimline/blue/filled/line{
	dir = 8
	},
/turf/open/floor/iron/white,
/area/station/security/medical)
"Z" = (
/obj/structure/cable,
/obj/effect/turf_decal/tile/blue,
/turf/open/floor/iron/white,
/area/station/security/medical)

(1,1,1) = {"
K
K
L
K
E
K
L
K
K
"}
(2,1,1) = {"
K
i
A
I
e
V
j
s
K
"}
(3,1,1) = {"
L
n
a
Q
M
Z
D
B
z
"}
(4,1,1) = {"
L
S
g
G
c
f
r
d
C
"}
(5,1,1) = {"
K
K
P
J
q
O
w
C
C
"}
(6,1,1) = {"
o
C
C
C
b
C
C
C
o
"}
