//MAP CONVERTED BY dmm2tgm.py THIS HEADER COMMENT PREVENTS RECONVERSION, DO NOT REMOVE
"aa" = (
/obj/structure/disposalpipe/segment,
/obj/structure/cable,
/obj/machinery/power/apc/auto_name/directional/west,
/obj/effect/turf_decal/trimline/yellow/line{
	dir = 8
	},
/obj/effect/turf_decal/trimline/yellow/mid_joiner{
	dir = 8
	},
/turf/open/floor/iron/edge{
	dir = 8
	},
/area/station/hallway/primary/aft)
"as" = (
/obj/structure/disposalpipe/segment,
/obj/effect/turf_decal/trimline/yellow/arrow_cw{
	dir = 4
	},
/obj/effect/turf_decal/trimline/yellow/mid_joiner{
	dir = 4
	},
/obj/effect/turf_decal/siding/dark{
	dir = 4
	},
/turf/open/floor/iron/edge{
	dir = 4
	},
/area/station/hallway/primary/aft)
"av" = (
/obj/structure/disposalpipe/segment{
	dir = 4
	},
/obj/effect/turf_decal/trimline/yellow/line,
/obj/effect/turf_decal/trimline/yellow/mid_joiner,
/obj/effect/turf_decal/siding/white/corner{
	color = "#8b8b8b";
	dir = 1
	},
/turf/open/floor/iron/corner{
	dir = 1
	},
/area/station/hallway/primary/aft)
"ay" = (
/obj/structure/cable,
/obj/machinery/atmospherics/pipe/smart/manifold4w/supply/hidden/layer4,
/obj/machinery/atmospherics/pipe/smart/manifold4w/scrubbers/hidden/layer2,
/obj/effect/turf_decal/trimline/yellow/corner{
	dir = 4
	},
/obj/effect/turf_decal/siding/dark{
	dir = 1
	},
/turf/open/floor/iron/large,
/area/station/hallway/primary/aft)
"aX" = (
/turf/template_noop,
/area/template_noop)
"bH" = (
/obj/structure/disposalpipe/segment,
/obj/effect/turf_decal/trimline/yellow/corner{
	dir = 4
	},
/obj/effect/turf_decal/siding/white{
	color = "#8b8b8b"
	},
/turf/open/floor/iron/edge,
/area/station/hallway/primary/aft)
"bN" = (
/obj/structure/cable,
/obj/machinery/atmospherics/pipe/smart/manifold4w/scrubbers/hidden/layer2,
/obj/machinery/atmospherics/pipe/smart/manifold4w/supply/hidden/layer4,
/obj/effect/turf_decal/siding/white{
	color = "#8b8b8b"
	},
/turf/open/floor/iron/textured_half,
/area/station/hallway/primary/aft)
"co" = (
/obj/structure/disposalpipe/segment,
/obj/effect/turf_decal/trimline/yellow/arrow_ccw{
	dir = 8
	},
/obj/effect/turf_decal/trimline/yellow/mid_joiner{
	dir = 8
	},
/obj/effect/turf_decal/siding/white/corner{
	color = "#8b8b8b"
	},
/obj/effect/turf_decal/siding/dark{
	dir = 8
	},
/turf/open/floor/iron/corner,
/area/station/hallway/primary/aft)
"cO" = (
/obj/machinery/door/airlock/maintenance,
/obj/effect/mapping_helpers/airlock/access/any/engineering/maintenance/departmental,
/turf/open/floor/iron/dark/smooth_large,
/area/station/maintenance/port/aft)
"cR" = (
/obj/machinery/light/directional/south,
/obj/machinery/incident_display/delam/directional/south,
/obj/effect/turf_decal/trimline/yellow/line,
/obj/effect/turf_decal/trimline/yellow/mid_joiner,
/obj/effect/turf_decal/siding/white/corner{
	color = "#8b8b8b";
	dir = 4
	},
/turf/open/floor/iron/edge,
/area/station/hallway/primary/aft)
"cW" = (
/obj/effect/turf_decal/siding/white/corner{
	color = "#8b8b8b";
	dir = 1
	},
/obj/effect/turf_decal/siding/dark{
	dir = 4
	},
/turf/open/floor/iron/corner{
	dir = 1
	},
/area/station/hallway/primary/aft)
"dW" = (
/obj/structure/disposalpipe/segment{
	dir = 4
	},
/obj/structure/cable,
/obj/machinery/atmospherics/pipe/smart/manifold4w/scrubbers/hidden/layer2,
/obj/machinery/atmospherics/pipe/smart/manifold4w/supply/hidden/layer4,
/turf/open/floor/iron,
/area/station/hallway/primary/aft)
"ee" = (
/turf/closed/wall/r_wall,
/area/station/maintenance/port/aft)
"eX" = (
/obj/structure/disposalpipe/segment,
/obj/structure/cable,
/obj/machinery/atmospherics/pipe/smart/manifold4w/scrubbers/hidden/layer2{
	dir = 4
	},
/obj/machinery/atmospherics/pipe/smart/manifold4w/supply/hidden/layer4{
	dir = 4
	},
/turf/open/floor/iron/edge{
	dir = 8
	},
/area/station/hallway/primary/aft)
"fe" = (
/obj/structure/cable,
/obj/machinery/atmospherics/pipe/smart/manifold4w/scrubbers/hidden/layer2,
/obj/machinery/atmospherics/pipe/smart/manifold4w/supply/hidden/layer4,
/obj/effect/turf_decal/trimline/yellow,
/obj/structure/marker_beacon/bronze,
/turf/open/floor/iron/large,
/area/station/hallway/primary/aft)
"fx" = (
/obj/structure/cable,
/obj/machinery/atmospherics/pipe/smart/manifold4w/scrubbers/hidden/layer2,
/obj/machinery/atmospherics/pipe/smart/manifold4w/supply/hidden/layer4,
/obj/effect/landmark/event_spawn,
/turf/open/floor/iron,
/area/station/hallway/primary/aft)
"fH" = (
/turf/closed/wall,
/area/station/hallway/primary/aft)
"gM" = (
/obj/structure/disposalpipe/segment{
	dir = 5
	},
/obj/machinery/atmospherics/components/unary/vent_scrubber/on/layer2{
	dir = 1
	},
/obj/effect/turf_decal/trimline/yellow/arrow_ccw,
/obj/effect/turf_decal/trimline/yellow/mid_joiner,
/obj/effect/turf_decal/siding/white{
	color = "#8b8b8b";
	dir = 1
	},
/turf/open/floor/iron/textured_half,
/area/station/hallway/primary/aft)
"gU" = (
/obj/machinery/atmospherics/components/unary/portables_connector/visible{
	dir = 4
	},
/obj/machinery/portable_atmospherics/pump,
/obj/effect/turf_decal/tile/blue/full,
/turf/open/floor/iron/dark/smooth_large,
/area/station/engineering/atmos)
"hd" = (
/obj/machinery/light/directional/east,
/obj/effect/turf_decal/trimline/yellow/line{
	dir = 4
	},
/obj/effect/turf_decal/trimline/yellow/mid_joiner{
	dir = 4
	},
/obj/effect/turf_decal/siding/white{
	color = "#8b8b8b";
	dir = 8
	},
/turf/open/floor/iron/textured_half{
	dir = 8
	},
/area/station/hallway/primary/aft)
"kK" = (
/obj/machinery/atmospherics/components/unary/portables_connector/visible{
	dir = 4
	},
/obj/machinery/portable_atmospherics/scrubber,
/obj/machinery/light/small/directional/south,
/obj/effect/turf_decal/tile/dark_red/full,
/turf/open/floor/iron/dark/smooth_large,
/area/station/engineering/atmos)
"kO" = (
/turf/open/floor/iron/dark/smooth_large,
/area/station/hallway/primary/aft)
"lz" = (
/obj/structure/disposalpipe/segment,
/obj/machinery/atmospherics/components/unary/vent_pump/on/layer4{
	dir = 8
	},
/obj/effect/turf_decal/trimline/yellow/corner,
/obj/effect/turf_decal/siding/dark/corner,
/turf/open/floor/iron/edge{
	dir = 4
	},
/area/station/hallway/primary/aft)
"lC" = (
/obj/structure/cable,
/obj/machinery/atmospherics/pipe/smart/manifold4w/scrubbers/hidden/layer2,
/obj/machinery/atmospherics/pipe/smart/manifold4w/supply/hidden/layer4{
	dir = 4
	},
/obj/effect/turf_decal/siding/white{
	color = "#8b8b8b";
	dir = 1
	},
/turf/open/floor/iron/edge{
	dir = 1
	},
/area/station/hallway/primary/aft)
"md" = (
/obj/machinery/light/directional/north,
/obj/effect/turf_decal/trimline/yellow/line{
	dir = 9
	},
/obj/effect/turf_decal/trimline/yellow/mid_joiner{
	dir = 8
	},
/obj/effect/turf_decal/trimline/yellow/mid_joiner{
	dir = 1
	},
/obj/effect/turf_decal/siding/dark{
	dir = 8
	},
/turf/open/floor/iron/corner,
/area/station/hallway/primary/aft)
"ni" = (
/obj/item/radio/intercom/directional/north,
/obj/effect/turf_decal/trimline/yellow/line{
	dir = 1
	},
/obj/effect/turf_decal/trimline/yellow/mid_joiner{
	dir = 1
	},
/obj/effect/turf_decal/siding/white/corner{
	color = "#8b8b8b";
	dir = 8
	},
/turf/open/floor/iron/corner{
	dir = 8
	},
/area/station/hallway/primary/aft)
"nl" = (
/obj/structure/cable,
/obj/machinery/atmospherics/pipe/smart/manifold4w/scrubbers/hidden/layer2{
	dir = 4
	},
/obj/machinery/atmospherics/pipe/smart/manifold4w/supply/hidden/layer4{
	dir = 4
	},
/obj/structure/disposalpipe/segment{
	dir = 4
	},
/obj/effect/turf_decal/siding/white{
	color = "#8b8b8b";
	dir = 8
	},
/turf/open/floor/iron/textured_half{
	dir = 8
	},
/area/station/hallway/primary/aft)
"no" = (
/obj/structure/disposalpipe/segment,
/obj/machinery/door/firedoor,
/obj/effect/turf_decal/trimline/yellow/warning{
	dir = 8
	},
/obj/effect/turf_decal/siding/dark/corner{
	dir = 8
	},
/turf/open/floor/iron/large,
/area/station/hallway/primary/aft)
"pB" = (
/obj/machinery/atmospherics/components/unary/vent_scrubber/on/layer2{
	dir = 8
	},
/obj/effect/turf_decal/trimline/yellow/corner{
	dir = 4
	},
/turf/open/floor/iron/edge{
	dir = 4
	},
/area/station/hallway/primary/aft)
"pL" = (
/obj/structure/cable,
/obj/machinery/atmospherics/pipe/smart/manifold4w/scrubbers/hidden/layer2,
/obj/machinery/atmospherics/pipe/smart/manifold4w/supply/hidden/layer4,
/turf/open/floor/iron,
/area/station/hallway/primary/aft)
"pV" = (
/obj/machinery/atmospherics/pipe/smart/manifold4w/scrubbers/hidden/layer2{
	dir = 4
	},
/obj/machinery/atmospherics/pipe/smart/manifold4w/supply/hidden/layer4{
	dir = 4
	},
/obj/structure/cable,
/obj/machinery/door/airlock/engineering{
	name = "Tech Storage"
	},
/obj/effect/landmark/navigate_destination,
/obj/effect/mapping_helpers/airlock/access/any/engineering/tech_storage,
/turf/open/floor/iron/large,
/area/station/engineering/storage/tech)
"pZ" = (
/obj/effect/turf_decal/trimline/yellow/corner{
	dir = 8
	},
/turf/open/floor/iron/corner{
	dir = 1
	},
/area/station/hallway/primary/aft)
"qp" = (
/obj/machinery/light/directional/west,
/obj/structure/closet/firecloset,
/turf/open/floor/iron/dark/smooth_large,
/area/station/hallway/primary/aft)
"rs" = (
/obj/structure/chair/plastic,
/turf/open/floor/iron/dark/smooth_large,
/area/station/hallway/primary/aft)
"rK" = (
/obj/machinery/door/airlock/engineering{
	name = "Construction Area"
	},
/obj/effect/mapping_helpers/airlock/access/any/engineering/construction,
/turf/open/floor/iron/large,
/area/station/construction)
"sG" = (
/obj/structure/disposalpipe/segment{
	dir = 6
	},
/obj/structure/cable,
/obj/machinery/atmospherics/pipe/smart/manifold4w/scrubbers/hidden/layer2{
	dir = 4
	},
/obj/machinery/atmospherics/pipe/smart/manifold4w/supply/hidden/layer4{
	dir = 4
	},
/turf/open/floor/iron/edge{
	dir = 4
	},
/area/station/hallway/primary/aft)
"sL" = (
/obj/machinery/door/firedoor,
/obj/effect/turf_decal/trimline/yellow/corner,
/obj/effect/turf_decal/siding/dark/corner{
	dir = 4
	},
/turf/open/floor/iron/large,
/area/station/hallway/primary/aft)
"sM" = (
/obj/effect/turf_decal/trimline/yellow/arrow_cw{
	dir = 4
	},
/obj/effect/turf_decal/trimline/yellow/mid_joiner{
	dir = 4
	},
/obj/effect/turf_decal/siding/white/corner{
	color = "#8b8b8b";
	dir = 8
	},
/turf/open/floor/iron/corner{
	dir = 8
	},
/area/station/hallway/primary/aft)
"to" = (
/obj/effect/turf_decal/siding/white{
	color = "#8b8b8b";
	dir = 8
	},
/obj/effect/turf_decal/siding/dark{
	dir = 4
	},
/turf/open/floor/iron/textured_half{
	dir = 8
	},
/area/station/hallway/primary/aft)
"tq" = (
/obj/effect/turf_decal/trimline/yellow/corner{
	dir = 4
	},
/obj/effect/turf_decal/siding/dark{
	dir = 4
	},
/turf/open/floor/iron/edge{
	dir = 4
	},
/area/station/hallway/primary/aft)
"uJ" = (
/obj/effect/turf_decal/siding/white/corner{
	color = "#8b8b8b";
	dir = 8
	},
/obj/effect/turf_decal/siding/dark{
	dir = 4
	},
/turf/open/floor/iron/edge{
	dir = 4
	},
/area/station/hallway/primary/aft)
"vb" = (
/obj/structure/disposalpipe/segment,
/obj/effect/turf_decal/trimline/yellow/corner{
	dir = 8
	},
/turf/open/floor/iron/edge{
	dir = 8
	},
/area/station/hallway/primary/aft)
"vo" = (
/obj/structure/disposalpipe/segment,
/obj/machinery/atmospherics/components/unary/vent_pump/on/layer4{
	dir = 4
	},
/obj/effect/turf_decal/siding/white/corner{
	color = "#8b8b8b";
	dir = 4
	},
/turf/open/floor/iron,
/area/station/hallway/primary/aft)
"wb" = (
/obj/effect/turf_decal/trimline/yellow/corner{
	dir = 4
	},
/obj/effect/turf_decal/siding/white/corner{
	color = "#8b8b8b";
	dir = 8
	},
/turf/open/floor/iron/corner{
	dir = 8
	},
/area/station/hallway/primary/aft)
"wg" = (
/obj/structure/disposalpipe/segment{
	dir = 5
	},
/turf/open/floor/iron,
/area/station/hallway/primary/aft)
"wr" = (
/obj/structure/disposalpipe/segment,
/obj/structure/cable,
/obj/machinery/atmospherics/pipe/smart/manifold4w/supply/hidden/layer4,
/obj/machinery/atmospherics/pipe/smart/manifold4w/scrubbers/hidden/layer2,
/turf/open/floor/iron/corner{
	dir = 4
	},
/area/station/hallway/primary/aft)
"wy" = (
/obj/structure/disposalpipe/segment{
	dir = 10
	},
/obj/machinery/camera/directional/east{
	c_tag = "Aft Primary Hallway 1";
	pixel_y = -22
	},
/obj/effect/turf_decal/trimline/yellow/line{
	dir = 4
	},
/obj/effect/turf_decal/trimline/yellow/mid_joiner{
	dir = 4
	},
/turf/open/floor/iron/edge{
	dir = 4
	},
/area/station/hallway/primary/aft)
"wK" = (
/obj/structure/disposalpipe/segment,
/obj/effect/turf_decal/trimline/yellow/arrow_ccw{
	dir = 8
	},
/obj/effect/turf_decal/trimline/yellow/mid_joiner{
	dir = 8
	},
/obj/effect/turf_decal/siding/white/corner{
	color = "#8b8b8b"
	},
/turf/open/floor/iron/corner,
/area/station/hallway/primary/aft)
"yB" = (
/obj/structure/cable,
/obj/machinery/atmospherics/pipe/smart/manifold4w/scrubbers/hidden/layer2,
/obj/machinery/atmospherics/pipe/smart/manifold4w/supply/hidden/layer4,
/obj/effect/turf_decal/siding/white{
	color = "#8b8b8b";
	dir = 1
	},
/turf/open/floor/iron/textured_half,
/area/station/hallway/primary/aft)
"yE" = (
/obj/structure/disposalpipe/segment,
/obj/item/radio/intercom/directional/west,
/obj/effect/turf_decal/trimline/yellow/line{
	dir = 8
	},
/obj/effect/turf_decal/trimline/yellow/mid_joiner{
	dir = 8
	},
/turf/open/floor/iron/edge{
	dir = 8
	},
/area/station/hallway/primary/aft)
"Ab" = (
/obj/structure/disposalpipe/segment,
/obj/effect/turf_decal/trimline/yellow/arrow_ccw{
	dir = 8
	},
/obj/effect/turf_decal/trimline/yellow/mid_joiner{
	dir = 8
	},
/turf/open/floor/iron/edge{
	dir = 8
	},
/area/station/hallway/primary/aft)
"Af" = (
/obj/structure/disposalpipe/segment,
/obj/effect/turf_decal/trimline/yellow/corner{
	dir = 8
	},
/obj/effect/turf_decal/siding/white/corner{
	color = "#8b8b8b";
	dir = 4
	},
/turf/open/floor/iron/edge,
/area/station/hallway/primary/aft)
"Am" = (
/obj/structure/disposalpipe/segment,
/obj/effect/turf_decal/trimline/yellow/corner{
	dir = 1
	},
/obj/effect/turf_decal/siding/white/corner{
	color = "#8b8b8b";
	dir = 4
	},
/turf/open/floor/iron/edge{
	dir = 8
	},
/area/station/hallway/primary/aft)
"Ay" = (
/obj/machinery/navbeacon{
	codes_txt = "patrol;next_patrol=AIE";
	location = "AftH"
	},
/obj/structure/cable,
/obj/machinery/atmospherics/pipe/smart/manifold4w/scrubbers/hidden/layer2,
/obj/machinery/atmospherics/pipe/smart/manifold4w/supply/hidden/layer4,
/obj/structure/disposalpipe/segment{
	dir = 4
	},
/obj/effect/turf_decal/siding/white{
	color = "#8b8b8b";
	dir = 4
	},
/turf/open/floor/iron/edge{
	dir = 4
	},
/area/station/hallway/primary/aft)
"AM" = (
/obj/machinery/firealarm/directional/east,
/obj/effect/turf_decal/trimline/yellow/arrow_cw{
	dir = 4
	},
/obj/effect/turf_decal/trimline/yellow/mid_joiner{
	dir = 4
	},
/obj/effect/turf_decal/siding/white/corner{
	color = "#8b8b8b";
	dir = 1
	},
/turf/open/floor/iron/edge{
	dir = 4
	},
/area/station/hallway/primary/aft)
"Bx" = (
/obj/machinery/airalarm/directional/west,
/obj/structure/table,
/obj/item/storage/fancy/cigarettes/cigpack_candy{
	pixel_x = -7;
	pixel_y = 7
	},
/obj/item/cigarette/candy{
	pixel_x = 0;
	pixel_y = 1
	},
/turf/open/floor/iron/dark/smooth_large,
/area/station/hallway/primary/aft)
"Cx" = (
/obj/machinery/light/directional/south,
/obj/effect/turf_decal/trimline/yellow/line{
	dir = 10
	},
/obj/effect/turf_decal/trimline/yellow/mid_joiner{
	dir = 8
	},
/obj/effect/turf_decal/trimline/yellow/mid_joiner,
/obj/effect/turf_decal/siding/dark{
	dir = 8
	},
/turf/open/floor/iron/corner{
	dir = 4
	},
/area/station/hallway/primary/aft)
"CA" = (
/obj/structure/disposalpipe/sorting/mail/flip{
	dir = 2
	},
/obj/effect/mapping_helpers/mail_sorting/engineering/ce_office,
/turf/open/floor/iron,
/area/station/hallway/primary/aft)
"CU" = (
/obj/structure/disposalpipe/segment,
/obj/machinery/status_display/evac/directional/west,
/obj/effect/turf_decal/trimline/yellow/line{
	dir = 8
	},
/obj/effect/turf_decal/trimline/yellow/mid_joiner{
	dir = 8
	},
/turf/open/floor/iron/edge{
	dir = 8
	},
/area/station/hallway/primary/aft)
"Ef" = (
/obj/effect/turf_decal/trimline/yellow/line{
	dir = 8
	},
/obj/effect/turf_decal/trimline/yellow/mid_joiner{
	dir = 8
	},
/obj/effect/turf_decal/siding/dark{
	dir = 8
	},
/turf/open/floor/iron/edge{
	dir = 8
	},
/area/station/hallway/primary/aft)
"EU" = (
/obj/structure/cable,
/obj/machinery/atmospherics/pipe/smart/manifold4w/scrubbers/hidden/layer2,
/obj/machinery/atmospherics/pipe/smart/manifold4w/supply/hidden/layer4,
/obj/machinery/door/firedoor,
/turf/open/floor/iron/large,
/area/station/hallway/primary/aft)
"EV" = (
/obj/structure/disposalpipe/segment,
/obj/effect/turf_decal/trimline/yellow/corner{
	dir = 1
	},
/obj/effect/turf_decal/siding/white{
	color = "#8b8b8b";
	dir = 4
	},
/obj/effect/turf_decal/siding/dark/corner{
	dir = 1
	},
/turf/open/floor/iron/edge{
	dir = 4
	},
/area/station/hallway/primary/aft)
"FU" = (
/obj/effect/turf_decal/trimline/yellow/arrow_ccw{
	dir = 8
	},
/obj/effect/turf_decal/trimline/yellow/mid_joiner{
	dir = 8
	},
/obj/effect/turf_decal/siding/dark{
	dir = 8
	},
/turf/open/floor/iron/edge{
	dir = 8
	},
/area/station/hallway/primary/aft)
"Hi" = (
/obj/structure/tank_holder/extinguisher,
/turf/open/floor/iron/dark/smooth_large,
/area/station/hallway/primary/aft)
"Hq" = (
/obj/structure/disposalpipe/segment,
/obj/effect/turf_decal/trimline/yellow/line{
	dir = 8
	},
/obj/effect/turf_decal/trimline/yellow/mid_joiner{
	dir = 8
	},
/obj/effect/turf_decal/siding/white{
	color = "#8b8b8b";
	dir = 4
	},
/turf/open/floor/iron/textured_half{
	dir = 8
	},
/area/station/hallway/primary/aft)
"HJ" = (
/obj/effect/turf_decal/trimline/yellow/arrow_ccw{
	dir = 9
	},
/obj/effect/turf_decal/trimline/yellow/mid_joiner{
	dir = 8
	},
/obj/effect/turf_decal/trimline/yellow/mid_joiner{
	dir = 1
	},
/obj/effect/turf_decal/siding/dark{
	dir = 1
	},
/obj/effect/turf_decal/siding/dark/corner{
	dir = 8
	},
/turf/open/floor/iron/corner,
/area/station/hallway/primary/aft)
"Ib" = (
/obj/structure/disposalpipe/segment,
/obj/effect/turf_decal/trimline/yellow/corner{
	dir = 4
	},
/obj/effect/turf_decal/siding/dark/corner{
	dir = 4
	},
/turf/open/floor/iron,
/area/station/hallway/primary/aft)
"IE" = (
/obj/structure/cable,
/obj/machinery/atmospherics/pipe/smart/manifold4w/supply/hidden/layer4,
/obj/machinery/atmospherics/pipe/smart/manifold4w/scrubbers/hidden/layer2,
/obj/structure/disposalpipe/segment{
	dir = 4
	},
/turf/open/floor/iron,
/area/station/hallway/primary/aft)
"Jk" = (
/obj/structure/disposalpipe/segment{
	dir = 9
	},
/turf/open/floor/iron,
/area/station/hallway/primary/aft)
"Jn" = (
/obj/structure/disposalpipe/segment{
	dir = 4
	},
/obj/machinery/atmospherics/pipe/smart/manifold4w/scrubbers/hidden/layer2{
	dir = 4
	},
/obj/machinery/atmospherics/pipe/smart/manifold4w/supply/hidden/layer4{
	dir = 4
	},
/obj/structure/cable,
/obj/machinery/door/airlock/maintenance,
/obj/effect/mapping_helpers/airlock/access/any/engineering/maintenance,
/obj/effect/mapping_helpers/airlock/unres{
	dir = 4
	},
/turf/open/floor/iron/dark/smooth_large,
/area/station/maintenance/aft)
"Jq" = (
/obj/effect/turf_decal/trimline/yellow/arrow_cw{
	dir = 5
	},
/obj/effect/turf_decal/trimline/yellow/mid_joiner{
	dir = 4
	},
/obj/effect/turf_decal/trimline/yellow/mid_joiner{
	dir = 1
	},
/obj/effect/turf_decal/siding/dark{
	dir = 1
	},
/turf/open/floor/iron/corner{
	dir = 8
	},
/area/station/hallway/primary/aft)
"KW" = (
/obj/structure/disposalpipe/segment,
/obj/machinery/camera/directional/west{
	c_tag = "Aft Primary Hallway 2"
	},
/obj/effect/turf_decal/trimline/yellow/arrow_ccw{
	dir = 8
	},
/obj/effect/turf_decal/trimline/yellow/mid_joiner{
	dir = 8
	},
/turf/open/floor/iron/edge{
	dir = 8
	},
/area/station/hallway/primary/aft)
"Lc" = (
/obj/structure/disposalpipe/segment{
	dir = 6
	},
/obj/effect/turf_decal/trimline/yellow/line{
	dir = 8
	},
/obj/effect/turf_decal/trimline/yellow/mid_joiner{
	dir = 8
	},
/obj/effect/turf_decal/siding/dark{
	dir = 8
	},
/turf/open/floor/iron/edge{
	dir = 8
	},
/area/station/hallway/primary/aft)
"Lh" = (
/obj/structure/disposalpipe/segment,
/obj/effect/turf_decal/trimline/yellow/arrow_ccw{
	dir = 8
	},
/obj/effect/turf_decal/trimline/yellow/mid_joiner{
	dir = 8
	},
/obj/machinery/light/directional/west,
/turf/open/floor/iron/edge{
	dir = 8
	},
/area/station/hallway/primary/aft)
"Li" = (
/obj/machinery/firealarm/directional/east,
/obj/effect/turf_decal/trimline/yellow/corner,
/obj/effect/turf_decal/siding/white/corner{
	color = "#8b8b8b";
	dir = 1
	},
/turf/open/floor/iron/edge{
	dir = 4
	},
/area/station/hallway/primary/aft)
"LC" = (
/obj/structure/disposalpipe/segment,
/turf/open/floor/iron,
/area/station/hallway/primary/aft)
"Nj" = (
/obj/effect/turf_decal/trimline/yellow/corner,
/turf/open/floor/iron,
/area/station/hallway/primary/aft)
"NF" = (
/obj/effect/spawner/structure/window/reinforced,
/turf/open/floor/plating,
/area/station/hallway/primary/aft)
"NQ" = (
/obj/structure/disposalpipe/segment{
	dir = 4
	},
/obj/effect/turf_decal/loading_area{
	dir = 8
	},
/turf/open/floor/iron/edge{
	dir = 4
	},
/area/station/hallway/primary/aft)
"OI" = (
/obj/effect/turf_decal/trimline/yellow/corner{
	dir = 4
	},
/turf/open/floor/iron/edge{
	dir = 4
	},
/area/station/hallway/primary/aft)
"OU" = (
/obj/structure/cable,
/obj/machinery/atmospherics/pipe/smart/manifold4w/supply/hidden/layer4,
/obj/machinery/atmospherics/pipe/smart/manifold4w/scrubbers/hidden/layer2,
/obj/structure/disposalpipe/junction/flip{
	dir = 2
	},
/obj/effect/turf_decal/trimline/yellow/corner{
	dir = 1
	},
/obj/effect/turf_decal/siding/dark/corner{
	dir = 1
	},
/turf/open/floor/iron/edge{
	dir = 8
	},
/area/station/hallway/primary/aft)
"PL" = (
/obj/structure/cable,
/obj/machinery/atmospherics/pipe/smart/manifold4w/scrubbers/hidden/layer2,
/obj/machinery/atmospherics/pipe/smart/manifold4w/supply/hidden/layer4,
/obj/effect/turf_decal/siding/white/corner{
	color = "#8b8b8b"
	},
/turf/open/floor/iron,
/area/station/hallway/primary/aft)
"Qb" = (
/obj/structure/sign/warning/secure_area/directional/west,
/turf/open/floor/iron/large,
/area/station/hallway/primary/aft)
"Qw" = (
/obj/structure/cable,
/obj/machinery/atmospherics/pipe/smart/manifold4w/scrubbers/hidden/layer2,
/obj/machinery/atmospherics/pipe/smart/manifold4w/supply/hidden/layer4{
	dir = 8
	},
/turf/open/floor/iron,
/area/station/hallway/primary/aft)
"QY" = (
/obj/structure/disposalpipe/segment,
/obj/effect/turf_decal/siding/white{
	color = "#8b8b8b";
	dir = 4
	},
/turf/open/floor/iron/edge{
	dir = 4
	},
/area/station/hallway/primary/aft)
"Re" = (
/turf/open/floor/iron/edge{
	dir = 4
	},
/area/station/hallway/primary/aft)
"RW" = (
/obj/structure/cable,
/obj/machinery/atmospherics/pipe/smart/manifold4w/scrubbers/hidden/layer2,
/obj/machinery/atmospherics/pipe/smart/manifold4w/supply/hidden/layer4{
	dir = 4
	},
/turf/open/floor/iron,
/area/station/hallway/primary/aft)
"Sc" = (
/obj/structure/disposalpipe/segment,
/obj/structure/cable,
/obj/machinery/atmospherics/pipe/smart/manifold4w/scrubbers/hidden/layer2{
	dir = 1
	},
/obj/machinery/atmospherics/pipe/smart/manifold4w/supply/hidden/layer4{
	dir = 4
	},
/obj/structure/disposalpipe/segment{
	dir = 4
	},
/obj/effect/turf_decal/trimline/yellow,
/obj/structure/marker_beacon/bronze,
/turf/open/floor/iron/large,
/area/station/hallway/primary/aft)
"SU" = (
/obj/structure/disposalpipe/segment,
/obj/effect/turf_decal/trimline/yellow/corner{
	dir = 1
	},
/obj/effect/turf_decal/siding/white/corner{
	color = "#8b8b8b"
	},
/turf/open/floor/iron,
/area/station/hallway/primary/aft)
"Td" = (
/obj/structure/table,
/obj/item/clothing/mask/gas,
/turf/open/floor/iron/dark/smooth_large,
/area/station/hallway/primary/aft)
"Tt" = (
/obj/structure/table,
/obj/item/stock_parts/power_store/cell/high{
	pixel_x = 6;
	pixel_y = -3
	},
/obj/item/crowbar/red,
/turf/open/floor/iron/dark/smooth_large,
/area/station/hallway/primary/aft)
"TZ" = (
/turf/open/floor/iron,
/area/station/hallway/primary/aft)
"Uh" = (
/obj/machinery/atmospherics/components/unary/portables_connector/visible{
	dir = 4
	},
/obj/machinery/portable_atmospherics/scrubber,
/obj/effect/turf_decal/tile/dark_red/full,
/turf/open/floor/iron/dark/smooth_large,
/area/station/engineering/atmos)
"UF" = (
/obj/structure/cable,
/obj/machinery/atmospherics/pipe/smart/manifold4w/scrubbers/hidden/layer2,
/obj/machinery/atmospherics/pipe/smart/manifold4w/supply/hidden/layer4,
/obj/effect/turf_decal/siding/white{
	color = "#8b8b8b"
	},
/turf/open/floor/iron/edge,
/area/station/hallway/primary/aft)
"UU" = (
/obj/structure/cable,
/obj/machinery/atmospherics/pipe/smart/manifold4w/scrubbers/hidden/layer2,
/obj/machinery/atmospherics/pipe/smart/manifold4w/supply/hidden/layer4,
/obj/effect/turf_decal/siding/white{
	color = "#8b8b8b";
	dir = 1
	},
/turf/open/floor/iron/edge{
	dir = 1
	},
/area/station/hallway/primary/aft)
"VJ" = (
/obj/structure/cable,
/obj/machinery/atmospherics/pipe/smart/manifold4w/scrubbers/hidden/layer2{
	dir = 8
	},
/obj/machinery/atmospherics/pipe/smart/manifold4w/supply/hidden/layer4{
	dir = 8
	},
/turf/open/floor/iron,
/area/station/hallway/primary/aft)
"WD" = (
/obj/structure/disposalpipe/segment,
/turf/open/floor/iron/edge{
	dir = 8
	},
/area/station/hallway/primary/aft)
"WI" = (
/obj/structure/cable,
/obj/machinery/atmospherics/pipe/smart/manifold4w/scrubbers/hidden/layer2,
/obj/machinery/atmospherics/pipe/smart/manifold4w/supply/hidden/layer4,
/obj/machinery/door/airlock/engineering{
	name = "Telecommunications"
	},
/obj/effect/mapping_helpers/airlock/access/any/engineering/tcoms,
/obj/effect/landmark/navigate_destination/tcomms,
/obj/effect/mapping_helpers/airlock/access/any/command/general,
/turf/open/floor/iron/large,
/area/station/tcommsat/computer)
"WU" = (
/obj/effect/turf_decal/siding/dark{
	dir = 1
	},
/obj/effect/turf_decal/siding/dark,
/turf/open/floor/iron/large,
/area/station/hallway/primary/aft)
"WW" = (
/obj/machinery/atmospherics/components/unary/portables_connector/visible{
	dir = 4
	},
/obj/machinery/portable_atmospherics/pump,
/obj/structure/window/reinforced/spawner/directional/north,
/obj/effect/turf_decal/tile/blue/full,
/turf/open/floor/iron/dark/smooth_large,
/area/station/engineering/atmos)
"Yd" = (
/obj/structure/disposalpipe/segment,
/obj/structure/extinguisher_cabinet/directional/west,
/obj/effect/turf_decal/trimline/yellow/corner{
	dir = 1
	},
/turf/open/floor/iron/edge{
	dir = 8
	},
/area/station/hallway/primary/aft)
"Yg" = (
/obj/effect/turf_decal/siding/white{
	color = "#8b8b8b";
	dir = 8
	},
/turf/open/floor/iron/textured_half{
	dir = 8
	},
/area/station/hallway/primary/aft)
"YK" = (
/obj/structure/closet/emcloset,
/turf/open/floor/iron/dark/smooth_large,
/area/station/hallway/primary/aft)
"Zx" = (
/obj/effect/turf_decal/trimline/yellow/corner,
/turf/open/floor/iron/edge,
/area/station/hallway/primary/aft)

(1,1,1) = {"
aX
aX
aX
aX
aX
aX
aX
aX
aX
aX
aX
aX
aX
aX
cO
ee
aX
aX
aX
aX
aX
aX
aX
WI
aX
"}
(2,1,1) = {"
aX
aX
aX
aX
aX
aX
aX
aX
aX
aX
aX
aX
aX
aX
kO
rs
Bx
NF
Tt
WU
Hi
qp
YK
ay
Qb
"}
(3,1,1) = {"
aX
aX
aX
pV
aX
aX
aX
aX
aX
aX
rK
aX
aX
aX
md
FU
Cx
fH
Td
HJ
Ef
FU
Lc
OU
wr
"}
(4,1,1) = {"
wK
Hq
Am
eX
vb
yE
KW
CU
Lh
Yd
WD
vb
Ab
aa
SU
QY
Af
no
co
EV
vo
CA
Jk
IE
Zx
"}
(5,1,1) = {"
bN
fe
UU
RW
VJ
Qw
pL
pL
pL
pL
pL
pL
fx
pL
UF
fe
yB
EU
bN
fe
lC
dW
PL
Ay
cR
"}
(6,1,1) = {"
sM
hd
AM
pB
sG
lz
as
Ib
LC
wg
TZ
TZ
Nj
tq
uJ
to
cW
sL
wb
Yg
Li
wy
bH
Sc
gM
"}
(7,1,1) = {"
aX
aX
aX
aX
Jn
aX
YK
Jq
OI
NQ
Re
Re
pZ
WW
gU
Uh
kK
aX
aX
aX
aX
aX
ni
nl
av
"}
