//MAP CONVERTED BY dmm2tgm.py THIS HEADER COMMENT PREVENTS RECONVERSION, DO NOT REMOVE
"ap" = (
/obj/machinery/atmospherics/pipe/smart/manifold4w/scrubbers/hidden/layer2,
/obj/effect/turf_decal/siding/wood/end,
/obj/structure/barricade/wooden/crude,
/turf/open/floor/plating,
/area/station/service/library/abandoned)
"aB" = (
/obj/machinery/door/airlock/atmos{
	name = "Atmospherics Maintenance"
	},
/obj/effect/mapping_helpers/airlock/access/any/medical/maintenance,
/turf/open/floor/plating,
/area/station/maintenance/aft)
"bb" = (
/obj/structure/disposalpipe/segment,
/obj/structure/cable,
/obj/machinery/atmospherics/pipe/smart/manifold4w/scrubbers/hidden/layer2{
	dir = 4
	},
/obj/machinery/atmospherics/pipe/smart/manifold4w/supply/hidden/layer4,
/turf/open/floor/plating,
/area/station/maintenance/aft)
"bl" = (
/obj/effect/decal/cleanable/dirt,
/turf/open/floor/wood,
/area/station/service/library/abandoned)
"bB" = (
/obj/structure/table,
/obj/item/paper_bin{
	pixel_x = -5;
	pixel_y = 5
	},
/obj/item/pen{
	pixel_x = -5;
	pixel_y = 6
	},
/turf/open/floor/iron/dark/smooth_large,
/area/station/maintenance/starboard/aft)
"cj" = (
/obj/machinery/light/small/directional/south,
/obj/effect/turf_decal/siding/dark{
	dir = 6
	},
/turf/open/floor/plating,
/area/station/maintenance/starboard/aft)
"cw" = (
/obj/structure/disposalpipe/segment{
	dir = 4
	},
/obj/structure/cable,
/obj/machinery/atmospherics/pipe/smart/manifold4w/scrubbers/hidden/layer2{
	dir = 4
	},
/obj/machinery/atmospherics/pipe/smart/manifold4w/supply/hidden/layer4{
	dir = 4
	},
/obj/effect/turf_decal/siding/dark{
	dir = 1
	},
/turf/open/floor/plating,
/area/station/maintenance/aft)
"dq" = (
/obj/structure/table,
/obj/item/storage/crayons,
/obj/item/trash/candle{
	pixel_y = 12
	},
/turf/open/floor/wood,
/area/station/service/library/abandoned)
"dx" = (
/obj/structure/table,
/obj/item/paper_bin{
	pixel_x = -11;
	pixel_y = 7
	},
/obj/effect/mapping_helpers/broken_floor,
/turf/open/floor/wood,
/area/station/service/library/abandoned)
"eg" = (
/obj/effect/landmark/blobstart,
/obj/effect/turf_decal/siding/dark{
	dir = 9
	},
/turf/open/floor/plating,
/area/station/maintenance/starboard/aft)
"eG" = (
/obj/item/trash/sosjerky,
/turf/open/floor/plating,
/area/station/maintenance/starboard/aft)
"fc" = (
/obj/structure/disposalpipe/segment{
	dir = 4
	},
/turf/open/floor/plating,
/area/station/maintenance/aft)
"fp" = (
/obj/structure/disposalpipe/segment,
/obj/structure/cable,
/obj/machinery/atmospherics/pipe/smart/manifold4w/scrubbers/hidden/layer2,
/obj/machinery/atmospherics/pipe/smart/manifold4w/supply/hidden/layer4,
/obj/structure/fence{
	dir = 4;
	pixel_y = 0
	},
/turf/open/floor/plating,
/area/station/maintenance/aft)
"fL" = (
/obj/machinery/atmospherics/components/unary/vent_pump/on/layer4{
	dir = 4
	},
/obj/effect/mapping_helpers/broken_floor,
/obj/item/chair,
/turf/open/floor/wood,
/area/station/service/library/abandoned)
"gS" = (
/obj/structure/disposalpipe/segment,
/obj/machinery/atmospherics/pipe/smart/manifold4w/supply/hidden/layer4{
	dir = 8
	},
/obj/machinery/atmospherics/pipe/smart/manifold4w/scrubbers/hidden/layer2{
	dir = 4
	},
/obj/structure/cable,
/turf/open/floor/plating,
/area/station/maintenance/starboard/aft)
"hi" = (
/obj/machinery/atmospherics/pipe/smart/manifold4w/scrubbers/hidden/layer2,
/obj/machinery/atmospherics/pipe/smart/manifold4w/supply/hidden/layer4,
/obj/structure/cable,
/turf/open/floor/plating,
/area/station/maintenance/starboard/aft)
"hP" = (
/obj/structure/bed/maint,
/turf/open/floor/iron/dark/smooth_large,
/area/station/maintenance/aft)
"ic" = (
/turf/open/floor/plating,
/area/station/maintenance/starboard/aft)
"is" = (
/obj/item/storage/toolbox/emergency{
	pixel_x = 5;
	pixel_y = -3
	},
/obj/item/stack/cable_coil/thirty{
	pixel_x = 5;
	pixel_y = -8
	},
/obj/effect/turf_decal/siding/dark{
	dir = 4
	},
/obj/effect/turf_decal/siding/dark/corner{
	dir = 1
	},
/turf/open/floor/plating,
/area/station/maintenance/starboard/aft)
"iB" = (
/obj/structure/disposalpipe/segment,
/obj/machinery/atmospherics/pipe/smart/manifold4w/scrubbers/hidden/layer2,
/obj/machinery/atmospherics/pipe/smart/manifold4w/supply/hidden/layer4{
	dir = 4
	},
/obj/structure/cable,
/obj/structure/fence/door{
	dir = 2
	},
/turf/open/floor/plating,
/area/station/maintenance/starboard/aft)
"iT" = (
/obj/structure/disposalpipe/segment{
	dir = 5
	},
/obj/machinery/atmospherics/pipe/smart/manifold4w/scrubbers/hidden/layer2,
/obj/machinery/atmospherics/pipe/smart/manifold4w/supply/hidden/layer4,
/obj/structure/cable,
/turf/open/floor/plating,
/area/station/maintenance/starboard/aft)
"jP" = (
/obj/effect/spawner/random/trash/mess,
/obj/effect/decal/cleanable/dirt,
/obj/effect/mapping_helpers/broken_floor,
/turf/open/floor/wood,
/area/station/service/library/abandoned)
"kp" = (
/obj/structure/disposalpipe/segment,
/obj/structure/cable,
/obj/machinery/atmospherics/pipe/smart/manifold4w/scrubbers/hidden/layer2,
/obj/machinery/atmospherics/pipe/smart/manifold4w/supply/hidden/layer4,
/obj/structure/fake_stairs/directional/south{
	icon_state = "flattexture";
	icon = 'modular_skyrat/modules/advanced_shuttles/icons/exploration_floor.dmi';
	pixel_y = 1
	},
/obj/structure/railing{
	dir = 4
	},
/obj/structure/railing{
	dir = 8
	},
/turf/open/floor/plating,
/area/station/maintenance/aft)
"kL" = (
/obj/effect/decal/cleanable/dirt,
/obj/effect/mapping_helpers/broken_floor,
/turf/open/floor/plating,
/area/station/service/library/abandoned)
"kM" = (
/obj/structure/disposalpipe/segment{
	dir = 4
	},
/obj/effect/turf_decal/siding/dark,
/turf/open/floor/plating,
/area/station/maintenance/aft)
"lT" = (
/obj/structure/sign/poster/random/directional/south,
/obj/machinery/atmospherics/pipe/smart/manifold4w/supply/hidden/layer4{
	dir = 9
	},
/obj/machinery/atmospherics/pipe/smart/manifold4w/scrubbers/hidden/layer2,
/obj/structure/cable,
/obj/effect/turf_decal/siding/dark{
	dir = 8
	},
/turf/open/floor/plating,
/area/station/maintenance/aft)
"mo" = (
/obj/structure/cable,
/obj/structure/disposalpipe/segment{
	dir = 4
	},
/obj/machinery/atmospherics/pipe/smart/manifold4w/supply/hidden/layer4{
	dir = 9
	},
/obj/machinery/atmospherics/pipe/smart/manifold4w/scrubbers/hidden/layer2,
/obj/structure/table{
	color = "#999999"
	},
/obj/item/reagent_containers/cup/glass/drinkingglass/shotglass{
	pixel_x = -7;
	pixel_y = 7
	},
/obj/item/flashlight/lantern/on{
	pixel_x = 5;
	pixel_y = 7
	},
/turf/open/floor/plating,
/area/station/maintenance/aft)
"mN" = (
/obj/structure/bookcase/random,
/turf/open/floor/plating,
/area/station/service/library/abandoned)
"nf" = (
/obj/structure/disposalpipe/segment{
	dir = 6
	},
/obj/structure/fence{
	dir = 4;
	pixel_y = 0
	},
/turf/open/floor/plating,
/area/station/maintenance/aft)
"nt" = (
/obj/effect/spawner/random/structure/crate_abandoned,
/turf/open/floor/iron/dark/smooth_large,
/area/station/maintenance/starboard/aft)
"nR" = (
/obj/structure/table{
	color = "#999999"
	},
/obj/effect/spawner/random/entertainment/cigarette_pack,
/obj/effect/spawner/random/entertainment/lighter{
	pixel_x = 4;
	pixel_y = 0
	},
/turf/open/floor/plating,
/area/station/maintenance/starboard/aft)
"oW" = (
/obj/effect/turf_decal/siding/dark{
	dir = 5
	},
/turf/open/floor/iron/dark/smooth_corner{
	dir = 8
	},
/area/station/maintenance/starboard/aft)
"px" = (
/obj/effect/mapping_helpers/broken_floor,
/turf/open/floor/plating,
/area/station/maintenance/aft)
"qV" = (
/obj/structure/table,
/obj/effect/spawner/random/maintenance,
/obj/effect/decal/cleanable/cobweb,
/turf/open/floor/iron/dark/smooth_large,
/area/station/maintenance/starboard/aft)
"ru" = (
/obj/effect/mapping_helpers/airlock/abandoned,
/obj/machinery/door/airlock/maintenance,
/obj/effect/mapping_helpers/airlock/access/any/science/maintenance,
/obj/machinery/atmospherics/pipe/smart/manifold4w/supply/hidden/layer4{
	dir = 4
	},
/obj/machinery/atmospherics/pipe/smart/manifold4w/scrubbers/hidden/layer2,
/obj/structure/cable,
/turf/open/floor/plating,
/area/station/service/library/abandoned)
"tB" = (
/obj/effect/decal/cleanable/dirt,
/obj/machinery/atmospherics/pipe/smart/manifold4w/supply/hidden/layer4{
	dir = 9
	},
/obj/effect/mapping_helpers/broken_floor,
/obj/machinery/atmospherics/pipe/smart/manifold4w/scrubbers/hidden/layer2,
/mob/living/carbon/human/species/monkey{
	name = "mon wick";
	desc = "...With a pencil!"
	},
/turf/open/floor/wood,
/area/station/service/library/abandoned)
"ui" = (
/obj/structure/disposalpipe/segment,
/obj/structure/cable,
/obj/structure/disposalpipe/segment{
	dir = 4
	},
/obj/machinery/atmospherics/pipe/smart/manifold4w/supply/hidden/layer4{
	dir = 9
	},
/obj/machinery/atmospherics/pipe/smart/manifold4w/scrubbers/hidden/layer2,
/turf/open/floor/plating,
/area/station/maintenance/aft)
"ux" = (
/obj/effect/spawner/random/trash/mess,
/turf/open/floor/iron/grimy,
/area/station/service/library/abandoned)
"va" = (
/obj/structure/cable,
/obj/structure/disposalpipe/segment{
	dir = 4
	},
/obj/machinery/atmospherics/pipe/smart/manifold4w/supply/hidden/layer4{
	dir = 4
	},
/obj/machinery/atmospherics/pipe/smart/manifold4w/scrubbers/hidden/layer2{
	dir = 4
	},
/obj/effect/turf_decal/siding/dark/corner{
	dir = 1
	},
/turf/open/floor/plating,
/area/station/maintenance/aft)
"vi" = (
/obj/item/stack/cable_coil/cut{
	pixel_x = 3;
	pixel_y = -8
	},
/turf/open/floor/iron/dark/smooth_large,
/area/station/maintenance/starboard/aft)
"vw" = (
/turf/closed/wall,
/area/station/maintenance/starboard/aft)
"vU" = (
/obj/structure/fake_stairs/directional/north{
	icon_state = "stairs-old";
	icon = 'modular_skyrat/modules/aesthetics/floors/icons/floors.dmi';
	color = "#555555";
	dir = 1;
	pixel_y = 1
	},
/turf/open/floor/plating,
/area/station/maintenance/starboard/aft)
"wB" = (
/obj/structure/disposalpipe/segment{
	dir = 4
	},
/obj/effect/turf_decal/siding/dark/corner,
/turf/open/floor/plating,
/area/station/maintenance/aft)
"wX" = (
/obj/machinery/vending/cola/pwr_game{
	premium = list(/obj/item/reagent_containers/cup/glass/drinkingglass/filled/nuka_cola = 1, /obj/item/reagent_containers/cup/soda_cans/air = 1, /obj/item/reagent_containers/cup/soda_cans/monkey_energy = 1, /obj/item/reagent_containers/cup/soda_cans/grey_bull = 1, /obj/item/reagent_containers/cup/glass/bottle/rootbeer = 1, /obj/item/reagent_containers/applicator/pill/maintenance/achievement = 5)
	},
/obj/effect/turf_decal/bot_white{
	color = "#0aceff"
	},
/turf/open/floor/plating,
/area/station/maintenance/starboard/aft)
"yy" = (
/obj/effect/turf_decal/siding/dark{
	dir = 6
	},
/turf/open/floor/iron/dark/smooth_corner{
	dir = 1
	},
/area/station/maintenance/starboard/aft)
"zd" = (
/turf/open/floor/plating,
/area/station/maintenance/aft)
"Ao" = (
/obj/effect/mapping_helpers/airlock/cyclelink_helper{
	dir = 4
	},
/obj/machinery/door/airlock/external,
/obj/effect/mapping_helpers/airlock/access/any/engineering/external,
/obj/effect/mapping_helpers/airlock/unres{
	dir = 4
	},
/turf/open/floor/plating/airless,
/area/station/maintenance/starboard/aft)
"BM" = (
/obj/effect/decal/cleanable/blood/old,
/turf/open/floor/wood,
/area/station/service/library/abandoned)
"Cy" = (
/obj/structure/table,
/obj/item/modular_computer/laptop{
	pixel_x = -6;
	pixel_y = 3
	},
/turf/open/floor/iron/dark/smooth_large,
/area/station/maintenance/starboard/aft)
"CT" = (
/obj/machinery/door/airlock/maintenance,
/obj/effect/mapping_helpers/airlock/access/any/science/maintenance,
/obj/effect/mapping_helpers/airlock/unres,
/turf/open/floor/iron/dark/smooth_large,
/area/station/maintenance/starboard/aft)
"Dg" = (
/obj/structure/disposalpipe/segment,
/obj/structure/cable,
/obj/machinery/atmospherics/pipe/smart/manifold4w/scrubbers/hidden/layer2,
/obj/machinery/atmospherics/pipe/smart/manifold4w/supply/hidden/layer4,
/turf/open/floor/plating,
/area/station/maintenance/aft)
"Dt" = (
/obj/structure/disposalpipe/segment,
/obj/structure/cable,
/obj/machinery/atmospherics/pipe/smart/manifold4w/scrubbers/hidden/layer2,
/obj/machinery/atmospherics/pipe/smart/manifold4w/supply/hidden/layer4,
/obj/structure/fake_stairs/directional/north{
	icon_state = "stairs-old";
	icon = 'modular_skyrat/modules/aesthetics/floors/icons/floors.dmi';
	color = "#555555";
	dir = 2;
	pixel_y = 1
	},
/obj/structure/railing/corner{
	dir = 1
	},
/obj/structure/railing/corner{
	dir = 4
	},
/turf/open/floor/plating,
/area/station/maintenance/aft)
"DO" = (
/obj/structure/fake_stairs/directional/north{
	icon_state = "stairs-old";
	icon = 'modular_skyrat/modules/aesthetics/floors/icons/floors.dmi';
	color = "#555555";
	dir = 4;
	pixel_y = 1
	},
/turf/open/floor/plating,
/area/station/maintenance/starboard/aft)
"Fa" = (
/obj/structure/disposalpipe/segment{
	dir = 9
	},
/obj/machinery/atmospherics/pipe/smart/manifold4w/supply/hidden/layer4{
	dir = 9
	},
/obj/machinery/atmospherics/pipe/smart/manifold4w/scrubbers/hidden/layer2,
/obj/structure/cable,
/obj/effect/turf_decal/siding/dark/corner{
	dir = 8
	},
/turf/open/floor/plating,
/area/station/maintenance/aft)
"Fd" = (
/obj/structure/cable,
/obj/structure/disposalpipe/segment{
	dir = 4
	},
/obj/structure/sign/poster/random/directional/north,
/obj/machinery/atmospherics/pipe/smart/manifold4w/supply/hidden/layer4{
	dir = 9
	},
/obj/machinery/atmospherics/pipe/smart/manifold4w/scrubbers/hidden/layer2,
/turf/open/floor/plating,
/area/station/maintenance/aft)
"FB" = (
/obj/structure/door_assembly/door_assembly_mai,
/turf/open/floor/iron/dark/smooth_large,
/area/station/maintenance/starboard/aft)
"Ga" = (
/obj/structure/chair/office/light,
/obj/effect/turf_decal/siding/dark{
	dir = 10
	},
/turf/open/floor/iron/dark/smooth_corner{
	dir = 4
	},
/area/station/maintenance/starboard/aft)
"Gn" = (
/obj/structure/disposalpipe/segment{
	dir = 10
	},
/obj/structure/cable,
/obj/machinery/atmospherics/pipe/smart/manifold4w/scrubbers/hidden/layer2,
/obj/machinery/atmospherics/pipe/smart/manifold4w/supply/hidden/layer4,
/obj/structure/fence/door{
	dir = 2
	},
/turf/open/floor/plating,
/area/station/maintenance/aft)
"Hh" = (
/obj/effect/spawner/random/maintenance,
/obj/structure/rack,
/turf/open/floor/plating,
/area/station/maintenance/starboard/aft)
"Ho" = (
/obj/structure/table,
/obj/item/stock_parts/power_store/cell/crap{
	pixel_x = -9;
	pixel_y = 7
	},
/obj/item/stack/rods{
	pixel_x = -2;
	pixel_y = 3
	},
/obj/item/assembly/igniter{
	pixel_x = 5;
	pixel_y = -2
	},
/turf/open/floor/iron/dark/smooth_large,
/area/station/maintenance/starboard/aft)
"HN" = (
/obj/effect/decal/cleanable/dirt,
/obj/machinery/atmospherics/components/unary/vent_scrubber/on/layer2{
	dir = 4
	},
/obj/item/pen{
	pixel_x = -4;
	pixel_y = 14
	},
/turf/open/floor/iron/grimy,
/area/station/service/library/abandoned)
"Ip" = (
/obj/machinery/light/small/directional/north,
/obj/effect/spawner/random/structure/closet_maintenance,
/turf/open/floor/iron/dark/smooth_large,
/area/station/maintenance/aft)
"Ir" = (
/obj/structure/table,
/obj/item/flashlight/lamp{
	start_on = 0
	},
/obj/effect/decal/cleanable/dirt,
/turf/open/floor/wood,
/area/station/service/library/abandoned)
"Iw" = (
/obj/effect/turf_decal/siding/dark{
	dir = 1;
	icon_state = "siding_plain_end"
	},
/turf/open/floor/plating,
/area/station/maintenance/starboard/aft)
"Ix" = (
/obj/structure/disposalpipe/segment,
/obj/machinery/atmospherics/pipe/smart/manifold4w/scrubbers/hidden/layer2,
/obj/machinery/atmospherics/pipe/smart/manifold4w/supply/hidden/layer4,
/obj/structure/cable,
/obj/effect/decal/cleanable/ash,
/turf/open/floor/plating,
/area/station/maintenance/starboard/aft)
"ID" = (
/obj/effect/spawner/random/trash/mess,
/obj/structure/fence{
	dir = 4;
	pixel_y = 0
	},
/turf/open/floor/plating,
/area/station/maintenance/aft)
"Jq" = (
/turf/closed/wall,
/area/station/maintenance/aft)
"KP" = (
/obj/effect/decal/cleanable/dirt,
/obj/structure/sign/poster/random/directional/east,
/obj/machinery/atmospherics/pipe/smart/manifold4w/supply/hidden/layer4{
	dir = 9
	},
/obj/machinery/atmospherics/pipe/smart/manifold4w/scrubbers/hidden/layer2,
/obj/effect/decal/remains/human,
/turf/open/floor/wood,
/area/station/service/library/abandoned)
"KW" = (
/obj/structure/table,
/obj/effect/spawner/random/maintenance,
/turf/open/floor/iron/dark/smooth_large,
/area/station/maintenance/starboard/aft)
"Lx" = (
/obj/effect/landmark/generic_maintenance_landmark,
/obj/effect/mapping_helpers/broken_floor,
/turf/open/floor/plating,
/area/station/service/library/abandoned)
"MP" = (
/obj/structure/trash_pile,
/obj/effect/turf_decal/siding/dark{
	dir = 8
	},
/turf/open/floor/plating,
/area/station/maintenance/aft)
"Ni" = (
/obj/structure/closet/crate/secure/trashcart,
/turf/open/floor/iron/dark/smooth_large,
/area/station/maintenance/aft)
"Nw" = (
/turf/open/floor/iron/dark/smooth_large,
/area/station/maintenance/starboard/aft)
"NS" = (
/obj/structure/disposalpipe/segment{
	dir = 6
	},
/obj/structure/cable,
/obj/machinery/atmospherics/pipe/smart/manifold4w/scrubbers/hidden/layer2{
	dir = 6
	},
/obj/machinery/atmospherics/pipe/smart/manifold4w/supply/hidden/layer4{
	dir = 6
	},
/obj/effect/turf_decal/siding/dark{
	dir = 1
	},
/turf/open/floor/plating,
/area/station/maintenance/aft)
"Ot" = (
/obj/effect/turf_decal/stripes/line{
	dir = 4
	},
/obj/effect/decal/cleanable/dirt,
/obj/machinery/atmospherics/pipe/smart/manifold4w/supply/hidden/layer4{
	dir = 9
	},
/obj/effect/mapping_helpers/broken_floor,
/obj/machinery/atmospherics/pipe/smart/manifold4w/scrubbers/hidden/layer2,
/obj/structure/cable,
/turf/open/floor/wood,
/area/station/service/library/abandoned)
"OE" = (
/obj/structure/cable,
/obj/machinery/atmospherics/pipe/smart/manifold4w/scrubbers/hidden/layer2{
	dir = 8
	},
/obj/machinery/atmospherics/pipe/smart/manifold4w/supply/hidden/layer4{
	dir = 8
	},
/obj/structure/disposalpipe/segment,
/obj/structure/fake_stairs/directional/south{
	icon_state = "flattexture";
	icon = 'modular_skyrat/modules/advanced_shuttles/icons/exploration_floor.dmi';
	pixel_y = 1
	},
/obj/structure/railing{
	dir = 4
	},
/obj/structure/railing{
	dir = 8
	},
/turf/open/floor/plating,
/area/station/maintenance/aft)
"OP" = (
/obj/machinery/atmospherics/pipe/smart/manifold4w/supply/hidden/layer4{
	dir = 9
	},
/obj/machinery/atmospherics/pipe/smart/manifold4w/scrubbers/hidden/layer2,
/obj/structure/cable,
/turf/open/floor/plating,
/area/station/maintenance/aft)
"Qc" = (
/obj/structure/cable,
/obj/structure/disposalpipe/segment{
	dir = 4
	},
/obj/machinery/atmospherics/pipe/smart/manifold4w/supply/hidden/layer4{
	dir = 9
	},
/obj/machinery/atmospherics/pipe/smart/manifold4w/scrubbers/hidden/layer2,
/turf/open/floor/plating,
/area/station/maintenance/aft)
"Qj" = (
/obj/effect/spawner/structure/window/reinforced,
/turf/open/floor/plating,
/area/station/maintenance/starboard/aft)
"Qs" = (
/obj/item/kirbyplants/random,
/obj/machinery/power/apc/auto_name/directional/north,
/obj/structure/cable,
/obj/effect/decal/cleanable/cobweb/cobweb2,
/turf/open/floor/wood,
/area/station/service/library/abandoned)
"QV" = (
/obj/structure/disposalpipe/segment{
	dir = 9
	},
/obj/structure/cable,
/obj/machinery/atmospherics/pipe/smart/manifold4w/scrubbers/hidden/layer2{
	dir = 4
	},
/obj/machinery/atmospherics/pipe/smart/manifold4w/supply/hidden/layer4{
	dir = 4
	},
/turf/open/floor/plating,
/area/station/maintenance/aft)
"RU" = (
/obj/effect/turf_decal/siding/dark,
/obj/effect/turf_decal/siding/dark/corner{
	dir = 1
	},
/turf/open/floor/plating,
/area/station/maintenance/starboard/aft)
"SN" = (
/obj/machinery/airalarm/directional/east,
/turf/open/floor/iron/grimy,
/area/station/service/library/abandoned)
"Td" = (
/obj/structure/fence{
	dir = 4;
	pixel_y = 0
	},
/turf/open/floor/plating,
/area/station/maintenance/starboard/aft)
"TF" = (
/obj/effect/turf_decal/siding/dark{
	dir = 9
	},
/turf/open/floor/iron/dark/smooth_corner,
/area/station/maintenance/starboard/aft)
"Ua" = (
/turf/template_noop,
/area/template_noop)
"Vh" = (
/obj/structure/table,
/obj/item/flashlight/lamp{
	pixel_x = -4;
	pixel_y = 12
	},
/obj/item/folder/white{
	pixel_x = -5;
	pixel_y = -8
	},
/obj/item/folder/white{
	pixel_x = -5;
	pixel_y = -6
	},
/turf/open/floor/iron/dark/smooth_large,
/area/station/maintenance/starboard/aft)
"Wl" = (
/obj/item/stack/sheet/cardboard,
/obj/item/broken_bottle{
	pixel_x = -3;
	pixel_y = 0
	},
/obj/item/reagent_containers/cup/glass/bottle/grenadine{
	pixel_x = -9;
	pixel_y = -1
	},
/obj/item/reagent_containers/cup/glass/drinkingglass/shotglass{
	pixel_x = 5;
	pixel_y = -6
	},
/turf/open/floor/iron/dark/smooth_large,
/area/station/maintenance/aft)
"Xy" = (
/obj/effect/turf_decal/siding/dark{
	dir = 8;
	icon_state = "siding_plain_end"
	},
/turf/open/floor/plating,
/area/station/maintenance/starboard/aft)
"XP" = (
/obj/structure/disposalpipe/segment{
	dir = 9
	},
/turf/open/floor/plating,
/area/station/maintenance/aft)
"Yn" = (
/obj/structure/closet/emcloset,
/obj/effect/decal/cleanable/cobweb,
/turf/open/floor/iron/dark/smooth_large,
/area/station/maintenance/aft)
"Zg" = (
/obj/structure/disposalpipe/segment,
/obj/structure/cable,
/obj/machinery/atmospherics/pipe/smart/manifold4w/scrubbers/hidden/layer2,
/obj/machinery/atmospherics/pipe/smart/manifold4w/supply/hidden/layer4,
/obj/structure/fake_stairs/directional/south{
	icon_state = "stairs-old";
	icon = 'modular_skyrat/modules/aesthetics/floors/icons/floors.dmi';
	color = "#555555";
	dir = 1;
	pixel_y = 1
	},
/obj/structure/railing/corner{
	dir = 8
	},
/obj/structure/railing/corner,
/turf/open/floor/plating,
/area/station/maintenance/aft)
"Zh" = (
/obj/structure/chair/stool/directional/east,
/turf/open/floor/plating,
/area/station/maintenance/starboard/aft)

(1,1,1) = {"
Ua
Ua
Ua
Ua
Ua
Ua
Ua
Ua
Ua
Ua
Ua
Ua
Ua
Ua
Ua
Ua
Ua
Ua
Ua
Ua
Ua
Ua
Ua
Ua
Ua
Ua
Ua
Ua
Ua
Ua
"}
(2,1,1) = {"
Ua
Ua
Zg
kp
Dt
Ua
Ua
Ua
Ua
Ua
Ua
Ua
Ua
Ua
Ua
Ua
Ua
Ua
Ua
Ua
Ua
Ua
Ua
Ua
Ua
Ua
Ua
Ua
Ua
Ua
"}
(3,1,1) = {"
Ua
Ua
Ua
Ua
Ua
Ua
Ua
Ua
Ua
Ua
Ua
Ua
Ua
Ua
Ua
Ua
Ua
Ua
Ua
Ua
Ua
Ua
Ua
Ua
Ua
Ua
Ua
Ua
Ua
Ua
"}
(4,1,1) = {"
Ua
Ua
Ua
Ua
Ua
Ua
Ua
Ua
Ua
Ua
Ua
Ua
Ua
Ua
Ua
Ua
Ua
Ua
Ua
Ua
Ua
Ua
Ua
Ua
Ua
Ua
Ua
Ua
Ua
Ua
"}
(5,1,1) = {"
Ua
Ua
Ua
Ua
Ua
Ua
Ua
Ua
Ua
Ua
Ua
Ua
Ua
Ua
Ua
Ua
Ua
Ua
Ua
Ua
Ua
Ua
Ua
Ua
Ua
Ua
Ua
Ua
Ua
Ua
"}
(6,1,1) = {"
Ua
Ua
Ua
Ua
Ua
Ua
Ua
Ua
Ua
Ua
Ua
Ua
Ua
Ua
Ua
Ua
Ua
Ua
Ua
Ua
Ua
Ua
Ua
Ua
Ua
Ua
Ua
Ua
Ua
Ua
"}
(7,1,1) = {"
Ua
Ua
Ua
Ua
Ua
Ua
Ua
Ua
Ua
Ua
Ua
Ua
Ua
Ua
Ua
Ua
Ua
Ua
Ua
Ua
Ua
Ua
Ua
Ua
Ua
Ua
Ua
Ua
Ua
Ua
"}
(8,1,1) = {"
Ua
Ua
Ua
Ua
Ua
Ua
Ua
Ua
Ua
Ua
Ua
Ua
Ua
Ua
Ua
Ua
Ua
Ua
Ua
Ua
Ua
Ua
Ua
Ua
Ua
Ua
Ua
Ua
Ua
Ua
"}
(9,1,1) = {"
Ua
Ua
Ua
Ua
Ua
Ua
Ua
Ua
Ua
Ua
Ua
Ua
Ua
Ua
Ua
Ua
Ua
Ua
Ua
Ua
Ua
Ua
Ua
Ua
Ua
Ua
Ua
Ua
Ua
Ua
"}
(10,1,1) = {"
Ua
Ua
Ua
Ua
Ua
Ua
Ua
Ua
Ua
Ua
Ua
Ua
Ua
Ua
Ua
Ua
Ua
Ua
Ua
Ua
Ua
Ua
Ua
Ua
Ua
Ua
Ua
Ua
Ua
Ua
"}
(11,1,1) = {"
Ua
Ua
Ua
Ua
Ua
Ua
Ua
Ua
Ua
Ua
Ua
Ua
Ua
Ua
Ua
Ua
Ua
Jq
Qc
fc
zd
Ua
Ir
jP
bl
mN
mN
Ua
Ua
Ua
"}
(12,1,1) = {"
Ua
Ua
Ua
Ua
Ua
Ua
Ua
Ua
Ua
Ua
Ua
Ua
Ua
Ua
Ua
Ua
Ua
Jq
Qc
wB
Jq
Ua
dx
BM
fL
HN
kL
Ua
Ua
Ua
"}
(13,1,1) = {"
Ua
Ua
Ua
Ua
Ua
Ua
Ua
Ua
Ua
Ua
Ua
Ua
Ua
Ua
Ua
Ua
Ua
aB
Qc
kM
Ni
Ua
dq
Lx
tB
ap
mN
Ua
Ua
Ua
"}
(14,1,1) = {"
Ua
Ua
Ua
Ua
Ua
Ua
Ua
Ua
Ua
Ua
Ua
Ua
Ua
Ua
Ua
Ua
Ua
Jq
Fd
kM
hP
Ua
Qs
Ot
KP
SN
ux
Ua
Ua
Ua
"}
(15,1,1) = {"
Ua
Ua
Ua
Ua
Ua
Ua
Ua
Ua
Ua
Ua
Ua
Ua
Ua
Ua
Ua
Ua
Ua
Jq
mo
kM
Wl
Ua
Ua
ru
Ua
Ua
Ua
Ua
Ua
Ua
"}
(16,1,1) = {"
Ua
Ua
Ua
Ua
Ua
Ua
Ua
Ua
Ua
Ua
Ua
Ua
Ua
Ua
Ua
Yn
NS
fp
ui
Fa
lT
Ua
Ua
Ua
Ua
Ua
Ua
Ua
Ua
Ua
"}
(17,1,1) = {"
Ua
Ua
Ua
Ua
Ua
Ua
Ua
Ua
Ua
Ua
Ua
Ua
Ua
Ua
Ua
Ip
cw
ID
fc
px
OP
Ua
Ua
Ua
Ua
Ua
Ua
Ua
Ua
Ua
"}
(18,1,1) = {"
Ua
Ua
Ua
Ua
Ua
Ua
Ua
Ua
Ua
Ua
Ua
Ua
Ua
Ua
Ua
MP
va
nf
XP
zd
Jq
Ua
Ua
Ua
Ua
Ua
Ua
Ua
Ua
Ua
"}
(19,1,1) = {"
Ua
Ua
Ua
Ua
Ua
Ua
Ua
Ua
Zg
OE
Dt
Ua
Ua
Ua
Ua
Dg
QV
Gn
bb
bb
bb
Ua
Ua
Ua
Ua
Ua
Ua
Ua
Ua
Ua
"}
(20,1,1) = {"
Ua
Ua
Ua
Ua
Ua
Ua
Ua
Ua
Ua
Ua
Ua
Ua
Ua
Ua
Ua
Ua
Ua
Ua
Ua
Ua
Ua
Ua
Ua
Ua
Ua
Ua
Ua
Ua
Ua
Ua
"}
(21,1,1) = {"
Ua
Ua
Ua
Ua
Ua
Ua
Ua
Ua
Ua
Ua
Ua
Ua
Ua
Ua
Ua
Ua
Ua
Ua
Ua
Ua
Ua
Ua
Ua
Ua
Ua
Ua
Ua
Ua
Ua
Ua
"}
(22,1,1) = {"
Ua
Ua
Ua
Ua
Ua
Ua
Ua
Ua
Ua
Ua
Ua
Ua
Ua
Ua
Ua
Ua
Ua
Ua
Ua
Ua
Ua
Ua
Ua
Ua
Ua
Ua
Ua
Ua
Ua
Ua
"}
(23,1,1) = {"
Ua
Ua
Ua
Ua
Ua
Ua
Ua
Ua
Ua
Ua
Ua
Ua
Ua
Ua
Ua
Ua
Ua
Ua
Ua
Ua
Ua
Ua
Ua
Ua
Ua
Ua
Ua
Ua
Ua
Ua
"}
(24,1,1) = {"
Ua
Ua
Ua
Ua
Ua
Ua
Ua
Ua
Ua
Ua
Ua
Ua
Ua
Ua
Ua
Ua
Ua
Ua
Ua
Ua
Ua
Ua
Ua
Ua
Ua
Ua
Ua
Ua
Ua
Ua
"}
(25,1,1) = {"
Ua
Ua
Ua
Ua
Ua
Ua
Ua
Ua
Ua
Ua
Ua
Ua
Ua
Ua
Ua
Ua
Ua
Ua
Ua
Ua
Ua
Ua
Ua
Ua
Ua
Ua
Ua
Ua
Ua
Ua
"}
(26,1,1) = {"
Ua
Ua
Ua
Ua
Ua
Ua
Ua
Ua
Ua
Ua
Ua
Ua
Ua
Ua
Ua
Ua
Ua
Ua
Ua
Ua
Ua
Ua
Ua
Ua
Ua
Ua
Ua
Ua
Ua
Ua
"}
(27,1,1) = {"
Ua
Ua
Ua
Ua
Ua
Ua
Ua
Ua
Ua
Ua
Ua
Ua
Ua
Ua
Ua
Ua
Ua
Ua
Ua
Ua
Ua
Ua
Ua
Ua
Ua
Ua
Ua
Ua
Ua
Ua
"}
(28,1,1) = {"
Ua
Ua
Ua
Ua
Ua
Ua
Ua
Ua
Ua
Ua
Ua
Ua
Ua
Ua
Ua
Ua
Ua
Ua
Ua
Ua
Ua
Ua
Ua
Ua
Ua
Ua
Ua
Ua
Ua
Ua
"}
(29,1,1) = {"
Ua
Ua
Ua
Ua
Ua
Ua
Ua
Ua
Ua
Ua
Ua
Ua
Ua
Ua
Ua
Ua
Ua
Ua
Ua
Ua
Ua
Ua
Ua
Ua
Ua
Ua
Ua
Ua
Ua
Ua
"}
(30,1,1) = {"
Ua
Ua
Ua
Ua
Ua
Ua
Ua
Ua
Ua
Ua
Ua
Ua
Ua
Ua
Ua
Ua
Ua
Ua
Ua
Ua
Ua
Ua
Ua
Ua
Ua
Ua
Ua
Ua
Ua
Ua
"}
(31,1,1) = {"
Ua
Ua
Ua
Ua
Ua
Ua
Ua
Ua
Ua
Ua
Ua
Ua
Ua
Ua
Ua
Ua
Ua
Ua
Ua
Ua
Ua
Ua
Ua
Ua
Ua
Ua
Ua
Ua
Ua
Ua
"}
(32,1,1) = {"
Ua
Ua
Ua
Ua
Ua
Ua
Ua
Ua
Ua
Ua
Ua
Ua
Ua
Ua
Ua
Ua
Ua
Ua
Ua
Ua
Ua
Ua
Ua
Ua
Ua
Ua
Ua
Ua
Ua
Ua
"}
(33,1,1) = {"
Ua
Ua
Ua
Ua
Ua
Ua
Ua
Ua
Ua
Ua
Ua
Ua
Ua
Ua
Ua
Ua
Ua
Ua
Ua
Ua
Ua
Ua
Ua
Ua
Ua
Ua
Ua
Ua
Ua
Ua
"}
(34,1,1) = {"
Ua
Ua
Ua
Ua
Ua
Ua
Ua
Ua
Ua
Ua
Ua
Ua
Ua
Ua
Ua
Ua
Ua
Ua
Ua
Ua
Ua
Ua
Ua
Ua
Ua
Ua
Ua
Ua
Ua
wX
"}
(35,1,1) = {"
Ua
Ua
Ua
Ua
Ua
Ua
Ua
Ua
Ua
Ua
Ua
Ua
Ua
Ua
Ua
Ua
Ua
Ua
Ua
Ua
Hh
Td
nR
Zh
eG
Ua
Ua
Ua
Ua
Ua
"}
(36,1,1) = {"
Ua
Ua
Ua
Ua
Ua
Ua
Ua
Ua
Ua
Ua
Ua
Ua
Ua
Ua
Ua
Ua
Ua
Ua
Ua
Ua
gS
iB
Ix
iT
hi
Ua
Ua
Ua
Ua
Ua
"}
(37,1,1) = {"
Ua
Ua
Ua
Ua
Ua
Ua
Ua
Ua
Ua
Ua
Ua
Ua
Ua
Ua
Ua
Ua
Ua
Ua
Ua
Ua
Ua
Ua
Ua
Ua
Ua
Ua
Ua
Ua
Ua
Ua
"}
(38,1,1) = {"
Ua
Ua
Ua
Ua
Ua
Ua
Ua
Ua
Ua
Ua
Ua
Ua
Ua
Ua
Ua
Ua
Ua
Ua
Ua
Ua
Ua
Ua
Ua
Ua
Ua
Ua
Ua
Ua
Ua
Ua
"}
(39,1,1) = {"
Ua
Ua
Ua
Ua
Ua
Ua
Ua
Ua
Ua
Ua
Ua
Ua
Ua
Ua
Ua
Ua
Ua
Ua
Ua
Ua
Ua
Ua
Ua
Ua
Ua
Ua
Ua
Ua
Ua
Ua
"}
(40,1,1) = {"
Ua
Ua
Ua
Ua
Ua
Ua
Ua
Ua
Ua
Ua
Ua
Ua
Ua
Ua
Ua
Ua
Ua
Ua
Ua
Ua
Ua
Ua
Ua
Ua
Ua
Ua
Ua
Ua
Ua
Ua
"}
(41,1,1) = {"
Ua
Ua
Ua
Ua
Ua
Ua
Ua
Ua
Ua
Ua
Ua
Ua
Ua
Ua
Ua
Ua
Ua
Ua
Ua
Ua
Ua
Ua
Ua
Ua
Ua
Ua
Ua
Ua
Ua
Ua
"}
(42,1,1) = {"
Ua
Ua
Ua
Ua
Ua
Ua
Ua
Ua
Ua
Ua
Ua
Ua
Ua
Ua
Ua
Ua
Ua
Ua
Ua
Ua
Ua
Ua
Ua
Ua
Ua
Ua
Ua
Ua
Ua
Ua
"}
(43,1,1) = {"
Ua
Ua
Ua
Ua
Ua
Ua
Ua
Ua
Ua
Ua
Ua
Ua
Ua
Ua
Ua
Ua
Ua
Ua
Ua
Ua
Ua
Ua
Ua
Ua
Ua
Ua
Ua
Ua
Ua
Ua
"}
(44,1,1) = {"
Ua
Ua
Ua
Ua
Ua
Ua
Ua
Ua
Ua
Ua
Ua
Ua
Ua
Ua
Ua
Ua
Ua
Ua
Ua
Ua
Ua
Ua
Ua
Ua
Ua
Ua
Ua
Ua
Ua
Ua
"}
(45,1,1) = {"
Ua
Ua
Ua
Ua
Ua
Ua
Ua
Ua
Ua
Ua
Ua
Ua
Ua
Ua
Ua
Ua
Ua
Ua
Ua
Ua
Ua
Ua
Ua
Ua
Ua
Ua
Ua
Ua
Ua
Ua
"}
(46,1,1) = {"
Ua
Ua
Ua
Ua
Ua
Ua
Ua
Ua
Ua
Ua
Ua
Ua
Ua
Ua
Ua
Ua
Ua
Ua
Ua
Ua
Ua
Ua
Ua
Ua
Ua
Ua
Ua
Ua
Ua
Ua
"}
(47,1,1) = {"
Ua
Ua
Ua
Ua
Ua
Ua
Ua
Ua
Ua
Ua
Ua
Ua
Ua
Ua
Ua
Ua
Ua
Ua
Ua
Ua
Ua
Ua
Ua
Ua
Ua
Ua
Ua
Ua
Ua
Ua
"}
(48,1,1) = {"
Ua
Ua
Ua
Ua
Ua
Ua
Ua
Ua
Ua
Ua
Ua
Ua
Ua
Ua
Ua
Ua
Ua
Ua
Ua
Ua
Ua
Ua
Ua
Ua
Ua
Ua
Ua
Ua
Ua
Ua
"}
(49,1,1) = {"
Ua
Ua
Ua
Ua
Ua
Ua
Ua
Ua
Ua
Ua
Ua
Ua
Ua
Ua
Ua
Ua
Ua
Ua
Ua
Ua
Ua
Ua
Ua
Ua
Ua
Ua
Ua
Ua
Ua
Ua
"}
(50,1,1) = {"
Ua
Ua
Ua
Ua
Ua
Ua
Ua
Ua
Ua
Ua
Ua
Ua
Ua
Ua
Ua
Ua
Ua
Ua
Ua
Ua
Ua
Ua
Ua
Ua
Ua
Ua
Ua
Ua
Ua
Ua
"}
(51,1,1) = {"
Ua
Ua
Ua
Ua
Ua
Ua
Ua
Ua
Ua
Ua
Ua
Ua
Ua
Ua
Ua
Ua
Ua
Ua
Ua
Ua
Ua
Ua
Ua
Ua
Ua
Ua
Ua
Ua
Ua
Ua
"}
(52,1,1) = {"
Ua
Ua
Ua
Ua
Ua
Ua
Ua
Ua
Ua
Ua
Ua
Ua
Ua
Ua
Ua
Ua
Ua
Ua
Ua
Ua
Ua
Ua
Ua
Ua
Ua
Ua
Ua
Ua
Ua
Ua
"}
(53,1,1) = {"
Ua
Ua
Ua
Ua
Ua
Ua
Ua
Ua
Ua
Ua
Ua
vw
vw
vw
vw
vw
vw
vw
vw
vw
DO
Ua
Ua
Ua
Ua
Ua
Ua
Ua
Ua
Ua
"}
(54,1,1) = {"
Ua
Ua
Ua
Ua
Ua
Ua
Ua
Ua
Ua
Ua
Ua
vU
ic
CT
Nw
Vh
bB
vw
qV
Ho
Xy
Ua
Ua
Ua
Ua
Ua
Ua
Ua
Ua
Ua
"}
(55,1,1) = {"
Ua
Ua
Ua
Ua
Ua
Ua
Ua
Ua
Ua
Ua
Ua
vw
vw
vw
TF
Ga
Cy
vw
KW
eg
RU
Ua
Ua
Ua
Ua
Ua
Ua
Ua
Ua
Ua
"}
(56,1,1) = {"
Ua
Ua
Ua
Ua
Ua
Ua
Ua
Ua
Ua
Ua
Ua
Ua
vw
nt
oW
yy
vi
FB
Iw
is
cj
Ua
Ua
Ua
Ua
Ua
Ua
Ua
Ua
Ua
"}
(57,1,1) = {"
Ua
Ua
Ua
Ua
Ua
Ua
Ua
Ua
Ua
Ua
Ua
Ua
vw
vw
Qj
Qj
Qj
vw
vw
vw
Ao
Ua
Ua
Ua
Ua
Ua
Ua
Ua
Ua
Ua
"}
