//MAP CONVERTED BY dmm2tgm.py THIS HEADER COMMENT PREVENTS RECONVERSION, DO NOT REMOVE
"a" = (
/turf/closed/wall,
/area/station/security/medical)
"c" = (
/obj/effect/turf_decal/trimline/red/real_red/filled/warning{
	dir = 4
	},
/obj/machinery/atmospherics/pipe/smart/manifold4w/supply/hidden/layer4,
/obj/machinery/door/window/brigdoor/right/directional/south{
	req_access = list("security");
	name = "Security Infirmary";
	dir = 4
	},
/obj/effect/turf_decal/siding/dark/corner,
/obj/effect/turf_decal/siding/dark/corner{
	dir = 4
	},
/obj/machinery/door/firedoor/border_only{
	dir = 4;
	pixel_x = 1;
	pixel_y = 0
	},
/turf/open/floor/iron/white,
/area/station/security/medical)
"d" = (
/obj/machinery/atmospherics/pipe/smart/manifold4w/supply/hidden/layer4,
/obj/effect/turf_decal/tile/red/real_red,
/obj/effect/turf_decal/tile/red/real_red{
	dir = 8
	},
/obj/effect/turf_decal/tile/red/real_red{
	dir = 1
	},
/turf/open/floor/iron/white,
/area/station/security/medical)
"e" = (
/obj/structure/window/reinforced/spawner/directional/east,
/obj/item/radio/intercom/directional/north,
/obj/effect/turf_decal/trimline/red/real_red/filled/line{
	dir = 5
	},
/obj/effect/turf_decal/siding/dark{
	dir = 5
	},
/obj/structure/closet/secure_closet/security_medic,
/turf/open/floor/iron/white,
/area/station/security/medical)
"j" = (
/obj/structure/cable,
/obj/machinery/atmospherics/components/unary/vent_scrubber/on/layer2{
	dir = 4
	},
/obj/effect/turf_decal/trimline/red/real_red/filled/line{
	dir = 6
	},
/obj/structure/window/reinforced/spawner/directional/east,
/obj/effect/turf_decal/siding/dark{
	dir = 4
	},
/obj/structure/table/reinforced,
/obj/machinery/computer/records/medical/laptop{
	dir = 8;
	pixel_y = 3;
	pixel_x = -4
	},
/turf/open/floor/iron/white,
/area/station/security/medical)
"k" = (
/obj/effect/turf_decal/trimline/red/real_red/filled/line{
	dir = 9
	},
/obj/effect/turf_decal/siding/dark{
	dir = 9
	},
/obj/structure/table/reinforced/rglass,
/obj/effect/spawner/surgery_tray/full,
/obj/machinery/status_display/ai/directional/north,
/obj/structure/sign/poster/official/cleanliness/directional/west,
/turf/open/floor/iron/white,
/area/station/security/medical)
"p" = (
/obj/structure/cable,
/obj/effect/turf_decal/trimline/red/real_red/filled/line,
/obj/effect/turf_decal/tile/red/real_red{
	dir = 1
	},
/obj/effect/turf_decal/siding/dark/corner{
	dir = 8
	},
/obj/structure/chair/office{
	dir = 4
	},
/obj/effect/landmark/start/security_medic,
/turf/open/floor/iron/white,
/area/station/security/medical)
"u" = (
/obj/effect/turf_decal/tile/neutral/fourcorners,
/obj/effect/turf_decal/trimline/red/real_red/end{
	dir = 8;
	alpha = 160
	},
/obj/structure/bodycontainer/morgue,
/obj/structure/window/reinforced/spawner/directional/north,
/turf/open/floor/iron/dark,
/area/station/security/medical)
"w" = (
/obj/effect/turf_decal/tile/neutral/half/contrasted{
	dir = 1
	},
/obj/effect/turf_decal/trimline/red/real_red/end{
	dir = 4;
	alpha = 160
	},
/obj/machinery/airalarm/directional/south,
/turf/open/floor/iron/dark,
/area/station/security/medical)
"y" = (
/obj/effect/turf_decal/trimline/red/real_red/filled/line{
	dir = 1
	},
/obj/effect/turf_decal/siding/dark{
	dir = 1
	},
/obj/machinery/stasis{
	dir = 4
	},
/obj/item/bedsheet/medical{
	dir = 4
	},
/obj/machinery/iv_drip,
/obj/machinery/wall_healer/directional/north,
/turf/open/floor/iron/white,
/area/station/security/medical)
"C" = (
/obj/machinery/camera/directional/west{
	c_tag = "Brig Infirmary"
	},
/obj/effect/turf_decal/trimline/red/real_red/filled/line{
	dir = 10
	},
/obj/effect/turf_decal/siding/dark{
	dir = 10
	},
/obj/machinery/computer/operating{
	dir = 4
	},
/obj/structure/sign/poster/official/moth_epi/directional/west,
/turf/open/floor/iron/white,
/area/station/security/medical)
"E" = (
/obj/effect/turf_decal/trimline/red/real_red/filled/line,
/obj/effect/turf_decal/siding/dark,
/turf/open/floor/iron/white,
/area/station/security/medical)
"J" = (
/obj/machinery/atmospherics/components/unary/vent_pump/on/layer4{
	dir = 4
	},
/obj/effect/turf_decal/tile/red/real_red,
/obj/effect/landmark/start/security_medic,
/turf/open/floor/iron/white,
/area/station/security/medical)
"K" = (
/obj/structure/window/reinforced/spawner/directional/east,
/obj/effect/turf_decal/tile/neutral/half/contrasted{
	dir = 1
	},
/obj/effect/turf_decal/tile/red/real_red/full,
/obj/effect/turf_decal/siding/dark{
	dir = 6
	},
/obj/structure/table/reinforced,
/obj/item/paper_bin{
	pixel_x = 2;
	pixel_y = 16
	},
/obj/item/pen{
	pixel_x = 3;
	pixel_y = 17
	},
/obj/item/reagent_containers/cup/glass/mug/nanotrasen{
	pixel_x = -8;
	pixel_y = 17
	},
/obj/item/folder/white{
	pixel_x = 3;
	pixel_y = -1
	},
/obj/item/folder/red{
	pixel_x = -1;
	pixel_y = -1
	},
/obj/item/reagent_containers/syringe{
	pixel_x = -5;
	pixel_y = -4
	},
/turf/open/floor/iron/white,
/area/station/security/medical)
"L" = (
/obj/effect/turf_decal/trimline/red/real_red/filled/line{
	dir = 1
	},
/obj/effect/turf_decal/siding/dark{
	dir = 1
	},
/obj/item/clothing/gloves/latex,
/obj/item/clothing/mask/surgical,
/obj/item/healthanalyzer,
/obj/structure/rack/shelf,
/obj/item/bodybag,
/obj/item/reagent_containers/spray/cleaner,
/obj/item/reagent_containers/cup/bottle/epinephrine,
/obj/item/reagent_containers/cup/bottle/multiver,
/obj/item/reagent_containers/cup/bottle/formaldehyde,
/obj/machinery/light/directional/north,
/obj/machinery/firealarm/directional/north,
/turf/open/floor/iron/white,
/area/station/security/medical)
"O" = (
/obj/machinery/power/apc/auto_name/directional/south,
/obj/structure/cable,
/obj/effect/turf_decal/tile/neutral/half/contrasted{
	dir = 1
	},
/obj/effect/turf_decal/tile/red/real_red/full,
/obj/structure/window/reinforced/spawner/directional/west{
	pixel_x = -3;
	pixel_y = 0
	},
/obj/effect/turf_decal/siding/dark{
	dir = 10
	},
/obj/structure/table/reinforced,
/obj/machinery/computer/crew{
	dir = 1
	},
/turf/open/floor/iron/white,
/area/station/security/medical)
"W" = (
/obj/effect/turf_decal/trimline/red/real_red/filled/line{
	dir = 8
	},
/obj/effect/turf_decal/siding/dark{
	dir = 8
	},
/obj/structure/table/optable,
/obj/structure/sink/directional/south,
/obj/machinery/defibrillator_mount/directional/west,
/turf/open/floor/iron/white,
/area/station/security/medical)

(1,1,1) = {"
a
a
a
a
a
a
"}
(2,1,1) = {"
a
k
W
C
u
a
"}
(3,1,1) = {"
a
y
J
E
w
a
"}
(4,1,1) = {"
a
L
d
p
O
a
"}
(5,1,1) = {"
a
e
c
j
K
a
"}
