//MAP CONVERTED BY dmm2tgm.py THIS HEADER COMMENT PREVENTS RECONVERSION, DO NOT REMOVE
"a" = (
/obj/effect/turf_decal/siding/wood{
	dir = 5
	},
/obj/machinery/camera{
	c_tag = "Blueshield's Office";
	dir = 6
	},
/obj/structure/hedge,
/turf/open/floor/wood/parquet,
/area/station/command/heads_quarters/blueshield)
"b" = (
/obj/machinery/atmospherics/pipe/smart/manifold4w/scrubbers/hidden/layer2,
/obj/effect/turf_decal/tile/blue/diagonal_centre,
/obj/structure/cable,
/obj/machinery/atmospherics/components/unary/vent_pump/on/layer4,
/turf/open/floor/iron/dark/diagonal,
/area/station/command/heads_quarters/blueshield)
"d" = (
/mob/living/basic/pet/dog/bullterrier{
	desc = "It's Walter, he bites criminals just as well as he bites toddlers";
	name = "Walter";
	real_name = "Walter"
	},
/obj/structure/bed/dogbed/ian{
	name = "Walter's bed";
	desc = "Lisa's bed! Looks comfy."
	},
/obj/effect/turf_decal/siding/wood{
	dir = 4
	},
/obj/machinery/airalarm/directional/east,
/turf/open/floor/wood/parquet,
/area/station/command/heads_quarters/blueshield)
"e" = (
/obj/machinery/light/directional/north,
/obj/effect/turf_decal/siding/thinplating_new/dark,
/obj/machinery/status_display/ai/directional/north,
/obj/structure/rack/shelf,
/obj/item/storage/medkit/brute,
/obj/item/storage/medkit/fire{
	pixel_y = 4
	},
/turf/open/floor/iron/dark/small,
/area/station/command/heads_quarters/blueshield)
"f" = (
/obj/effect/turf_decal/siding/wood,
/turf/open/floor/wood/parquet,
/area/station/command/heads_quarters/blueshield)
"g" = (
/obj/machinery/atmospherics/pipe/smart/manifold4w/scrubbers/hidden/layer2,
/obj/machinery/atmospherics/pipe/smart/manifold4w/supply/hidden/layer4{
	dir = 4
	},
/obj/effect/turf_decal/siding/wood{
	dir = 1
	},
/obj/structure/cable,
/turf/open/floor/wood/parquet,
/area/station/command/heads_quarters/blueshield)
"h" = (
/obj/machinery/light/directional/north,
/obj/machinery/atmospherics/pipe/smart/manifold4w/scrubbers/hidden/layer2,
/obj/machinery/atmospherics/pipe/smart/manifold4w/supply/hidden/layer4{
	dir = 4
	},
/obj/machinery/computer/crew,
/obj/machinery/button/door/directional/north{
	id = "blueshield_priv";
	name = "Privacy Shutters Control";
	req_access = list("cent_officer")
	},
/obj/structure/cable,
/turf/open/floor/carpet/blue,
/area/station/command/heads_quarters/blueshield)
"k" = (
/obj/machinery/newscaster/directional/west,
/turf/open/floor/carpet/blue,
/area/station/command/heads_quarters/blueshield)
"l" = (
/obj/effect/turf_decal/tile/blue/diagonal_centre,
/obj/structure/sign/poster/official/enlist/directional/east,
/obj/machinery/light_switch/directional/south,
/turf/open/floor/iron/dark/diagonal,
/area/station/command/heads_quarters/blueshield)
"m" = (
/obj/effect/turf_decal/siding/thinplating_new/dark,
/obj/machinery/airalarm/directional/north,
/obj/structure/rack/shelf,
/obj/item/storage/toolbox/ammobox/wt550m9,
/turf/open/floor/iron/dark/small,
/area/station/command/heads_quarters/blueshield)
"o" = (
/obj/structure/table/reinforced/titaniumglass,
/obj/item/sign/flag/nanotrasen{
	pixel_y = 9;
	pixel_x = -6
	},
/obj/item/folder/blue{
	pixel_y = 1;
	pixel_x = 7
	},
/obj/item/storage/fancy/donut_box,
/turf/open/floor/carpet/blue,
/area/station/command/heads_quarters/blueshield)
"p" = (
/obj/machinery/atmospherics/pipe/smart/manifold4w/scrubbers/hidden/layer2,
/obj/machinery/atmospherics/pipe/smart/manifold4w/supply/hidden/layer4{
	dir = 4
	},
/obj/structure/cable,
/turf/open/floor/carpet/blue,
/area/station/command/heads_quarters/blueshield)
"q" = (
/obj/structure/chair/comfy/brown,
/obj/effect/landmark/start/blueshield,
/turf/open/floor/carpet/blue,
/area/station/command/heads_quarters/blueshield)
"r" = (
/obj/effect/turf_decal/siding/thinplating_new/dark,
/obj/machinery/suit_storage_unit/security,
/obj/structure/sign/flag/nanotrasen/directional/north,
/turf/open/floor/iron/dark/small,
/area/station/command/heads_quarters/blueshield)
"s" = (
/obj/effect/turf_decal/siding/thinplating_new/dark,
/obj/machinery/power/apc/auto_name/directional/north,
/obj/structure/cable,
/obj/structure/closet/secure_closet/blueshield,
/turf/open/floor/iron/dark/small,
/area/station/command/heads_quarters/blueshield)
"t" = (
/obj/effect/turf_decal/tile/blue/diagonal_centre,
/obj/structure/extinguisher_cabinet/directional/west,
/turf/open/floor/iron/dark/diagonal,
/area/station/command/heads_quarters/blueshield)
"u" = (
/obj/effect/turf_decal/siding/wood/corner{
	dir = 1
	},
/turf/open/floor/wood/parquet,
/area/station/command/heads_quarters/blueshield)
"w" = (
/obj/machinery/atmospherics/pipe/smart/manifold4w/scrubbers/hidden/layer2,
/obj/effect/turf_decal/siding/wood,
/turf/open/floor/wood/parquet,
/area/station/command/heads_quarters/blueshield)
"x" = (
/obj/machinery/modular_computer/preset/command,
/obj/machinery/status_display/evac/directional/north,
/turf/open/floor/carpet/blue,
/area/station/command/heads_quarters/blueshield)
"y" = (
/obj/effect/turf_decal/siding/wood{
	dir = 8
	},
/obj/effect/mapping_helpers/turn_off_lights_with_lightswitch,
/turf/open/floor/wood/parquet,
/area/station/command/heads_quarters/blueshield)
"z" = (
/obj/effect/turf_decal/tile/blue/diagonal_centre,
/obj/structure/cable,
/obj/machinery/atmospherics/pipe/smart/manifold4w/scrubbers/hidden/layer2,
/obj/effect/landmark/start/blueshield,
/turf/open/floor/iron/dark/diagonal,
/area/station/command/heads_quarters/blueshield)
"A" = (
/obj/machinery/atmospherics/components/unary/vent_scrubber/on/layer2,
/obj/effect/turf_decal/siding/wood{
	dir = 1
	},
/obj/structure/chair/wood{
	dir = 1
	},
/turf/open/floor/wood/parquet,
/area/station/command/heads_quarters/blueshield)
"C" = (
/obj/structure/cable,
/obj/machinery/atmospherics/pipe/smart/manifold4w/supply/hidden/layer4{
	dir = 4
	},
/obj/machinery/atmospherics/pipe/smart/manifold4w/scrubbers/hidden/layer2,
/obj/effect/mapping_helpers/airlock/access/all/cent_com/blueshield,
/obj/effect/landmark/navigate_destination/autoname,
/obj/machinery/door/airlock/corporate{
	name = "Blueshield's Office"
	},
/turf/open/floor/iron/dark/textured_large,
/area/station/command/heads_quarters/blueshield)
"D" = (
/obj/machinery/atmospherics/pipe/smart/manifold4w/scrubbers/hidden/layer2,
/obj/machinery/atmospherics/pipe/smart/manifold4w/supply/hidden/layer4{
	dir = 4
	},
/obj/structure/table/reinforced/titaniumglass,
/obj/item/paper_bin{
	pixel_y = 5;
	pixel_x = -4
	},
/obj/item/pen/fountain/nanotrasen{
	pixel_y = 5;
	pixel_x = -4
	},
/obj/item/stamp/granted{
	pixel_x = 8;
	pixel_y = 9
	},
/obj/item/stamp/denied{
	pixel_x = 8;
	pixel_y = 3
	},
/obj/structure/cable,
/turf/open/floor/carpet/blue,
/area/station/command/heads_quarters/blueshield)
"E" = (
/turf/closed/wall/r_wall,
/area/station/command/heads_quarters/blueshield)
"F" = (
/obj/machinery/atmospherics/pipe/smart/manifold4w/supply/hidden/layer4{
	dir = 4
	},
/obj/machinery/atmospherics/pipe/smart/manifold4w/scrubbers/hidden/layer2,
/obj/effect/mapping_helpers/airlock/access/all/cent_com/blueshield,
/obj/machinery/door/airlock/highsecurity{
	name = "Blueshield's Armory"
	},
/obj/structure/cable,
/turf/open/floor/iron/dark/textured_large,
/area/station/command/heads_quarters/blueshield)
"H" = (
/obj/effect/turf_decal/siding/wood{
	dir = 9
	},
/obj/structure/sign/poster/official/nanotrasen_logo/directional/west,
/turf/open/floor/wood/parquet,
/area/station/command/heads_quarters/blueshield)
"L" = (
/obj/structure/cable,
/obj/machinery/atmospherics/pipe/smart/manifold4w/scrubbers/hidden/layer2,
/obj/machinery/atmospherics/pipe/smart/manifold4w/supply/hidden/layer4{
	dir = 4
	},
/obj/effect/turf_decal/siding/wood,
/turf/open/floor/wood/parquet,
/area/station/command/heads_quarters/blueshield)
"M" = (
/obj/machinery/light/directional/east,
/obj/effect/turf_decal/siding/wood{
	dir = 4
	},
/obj/structure/filingcabinet/medical{
	pixel_x = -10;
	icon_state = "employmentcabinet";
	name = "medical records filing cabinet"
	},
/obj/structure/filingcabinet/employment{
	name = "employment forms filing cabinet"
	},
/obj/structure/filingcabinet/security{
	pixel_x = 10;
	icon_state = "employmentcabinet";
	name = "security records filing cabinet"
	},
/obj/structure/sign/flag/nanotrasen/directional/east,
/turf/open/floor/wood/parquet,
/area/station/command/heads_quarters/blueshield)
"O" = (
/obj/structure/cable,
/obj/effect/spawner/structure/window/reinforced,
/obj/machinery/door/poddoor/shutters/preopen{
	id = "blueshield_priv";
	name = "Privacy Shutters"
	},
/turf/open/floor/plating,
/area/station/command/heads_quarters/blueshield)
"P" = (
/obj/structure/table/reinforced/titaniumglass,
/obj/machinery/recharger{
	pixel_y = 3;
	pixel_x = -6
	},
/obj/item/flashlight/lamp/green{
	pixel_y = 14;
	pixel_x = 5
	},
/obj/item/phone{
	pixel_x = 8;
	pixel_y = -1
	},
/obj/machinery/light/directional/west,
/obj/structure/noticeboard/directional/west,
/turf/open/floor/carpet/blue,
/area/station/command/heads_quarters/blueshield)
"Q" = (
/obj/effect/turf_decal/tile/blue/diagonal_centre,
/obj/structure/cable,
/obj/machinery/atmospherics/components/unary/vent_scrubber/on/layer2{
	dir = 4
	},
/turf/open/floor/iron/dark/diagonal,
/area/station/command/heads_quarters/blueshield)
"R" = (
/obj/effect/turf_decal/siding/wood{
	dir = 9
	},
/obj/machinery/atmospherics/pipe/smart/manifold4w/supply/hidden/layer4{
	dir = 4
	},
/obj/machinery/atmospherics/pipe/smart/manifold4w/scrubbers/hidden/layer2,
/obj/structure/cable,
/turf/open/floor/wood/parquet,
/area/station/command/heads_quarters/blueshield)
"T" = (
/obj/machinery/photocopier/prebuilt,
/obj/effect/turf_decal/siding/wood{
	dir = 4
	},
/obj/structure/extinguisher_cabinet/directional/east,
/turf/open/floor/wood/parquet,
/area/station/command/heads_quarters/blueshield)
"U" = (
/obj/effect/turf_decal/siding/wood{
	dir = 8
	},
/obj/effect/turf_decal/siding/wood{
	dir = 8
	},
/obj/machinery/atmospherics/components/unary/vent_pump/on/layer4{
	dir = 8
	},
/turf/open/floor/wood/parquet,
/area/station/command/heads_quarters/blueshield)
"W" = (
/obj/machinery/light/directional/north,
/obj/effect/turf_decal/siding/thinplating_new/dark,
/obj/machinery/status_display/evac/directional/north,
/obj/structure/closet/secure_closet/tac{
	req_access = list("cent_officer")
	},
/obj/item/clothing/suit/armor/riot,
/obj/item/clothing/head/helmet/toggleable/riot{
	pixel_y = 6
	},
/obj/structure/sign/poster/official/nanotrasen_logo/directional/west,
/turf/open/floor/iron/dark/small,
/area/station/command/heads_quarters/blueshield)
"X" = (
/obj/machinery/light_switch/directional/south,
/obj/structure/hedge,
/obj/effect/turf_decal/siding/wood{
	dir = 6
	},
/turf/open/floor/wood/parquet,
/area/station/command/heads_quarters/blueshield)
"Y" = (
/obj/effect/turf_decal/siding/wood{
	dir = 10
	},
/obj/structure/grandfatherclock,
/obj/machinery/firealarm/directional/south,
/turf/open/floor/wood/parquet,
/area/station/command/heads_quarters/blueshield)
"Z" = (
/obj/machinery/computer/security,
/obj/structure/sign/calendar/directional/north,
/obj/item/radio/intercom/directional/west,
/turf/open/floor/carpet/blue,
/area/station/command/heads_quarters/blueshield)

(1,1,1) = {"
E
E
E
E
E
E
E
E
E
E
"}
(2,1,1) = {"
E
W
t
E
Z
k
P
H
Y
E
"}
(3,1,1) = {"
E
s
Q
E
x
q
o
A
w
O
"}
(4,1,1) = {"
E
r
z
E
h
p
D
g
L
C
"}
(5,1,1) = {"
E
m
b
F
R
U
y
u
f
O
"}
(6,1,1) = {"
E
e
l
E
a
d
M
T
X
E
"}
(7,1,1) = {"
E
E
E
E
E
E
E
E
E
E
"}
