//MAP CONVERTED BY dmm2tgm.py THIS HEADER COMMENT PREVENTS RECONVERSION, DO NOT REMOVE
"a" = (
/turf/template_noop,
/area/template_noop)
"c" = (
/obj/machinery/atmospherics/components/unary/vent_scrubber/on/layer2,
/obj/structure/table/reinforced/titaniumglass,
/obj/item/paper_bin{
	pixel_y = 5;
	pixel_x = -4
	},
/obj/item/stamp/granted{
	pixel_x = 8;
	pixel_y = 8
	},
/obj/item/stamp/denied{
	pixel_x = 8;
	pixel_y = 3
	},
/obj/item/pen/fountain/nanotrasen{
	pixel_y = 5;
	pixel_x = -4
	},
/turf/open/floor/carpet/blue,
/area/station/command/heads_quarters/blueshield)
"d" = (
/obj/structure/cable,
/obj/machinery/atmospherics/pipe/smart/manifold4w/supply/hidden/layer4,
/obj/machinery/atmospherics/pipe/smart/manifold4w/scrubbers/hidden/layer2,
/obj/effect/turf_decal/siding/wood,
/obj/effect/turf_decal/siding/wood{
	dir = 1
	},
/turf/open/floor/wood/parquet,
/area/station/command/heads_quarters/blueshield)
"e" = (
/obj/structure/table/reinforced/titaniumglass,
/obj/machinery/recharger{
	pixel_y = 3;
	pixel_x = -6
	},
/obj/item/flashlight/lamp/green{
	pixel_y = 14;
	pixel_x = 5
	},
/obj/item/phone{
	pixel_x = 8;
	pixel_y = -1
	},
/turf/open/floor/carpet/blue,
/area/station/command/heads_quarters/blueshield)
"f" = (
/obj/machinery/firealarm/directional/west,
/obj/structure/reagent_dispensers/wall/peppertank/directional/north,
/obj/machinery/atmospherics/components/unary/vent_scrubber/on/layer2{
	dir = 4
	},
/obj/effect/turf_decal/tile/blue/diagonal_centre,
/turf/open/floor/iron/dark/diagonal,
/area/station/command/heads_quarters/blueshield)
"h" = (
/obj/structure/cable,
/obj/machinery/atmospherics/pipe/smart/manifold4w/supply/hidden/layer4,
/obj/machinery/atmospherics/pipe/smart/manifold4w/scrubbers/hidden/layer2,
/obj/effect/turf_decal/siding/wood{
	dir = 1
	},
/obj/effect/turf_decal/siding/wood,
/obj/structure/noticeboard/directional/south,
/turf/open/floor/wood/parquet,
/area/station/command/heads_quarters/blueshield)
"j" = (
/obj/machinery/atmospherics/pipe/smart/manifold4w/supply/hidden/layer4,
/obj/machinery/atmospherics/pipe/smart/manifold4w/scrubbers/hidden/layer2,
/obj/structure/cable,
/obj/effect/turf_decal/tile/blue/diagonal_centre,
/turf/open/floor/iron/dark/diagonal,
/area/station/command/heads_quarters/blueshield)
"l" = (
/obj/structure/cable,
/obj/machinery/atmospherics/pipe/smart/manifold4w/supply/hidden/layer4,
/obj/machinery/atmospherics/pipe/smart/manifold4w/scrubbers/hidden/layer2,
/obj/structure/sign/poster/official/nanotrasen_logo/directional/west,
/obj/effect/turf_decal/siding/wood/end{
	dir = 8
	},
/turf/open/floor/wood/parquet,
/area/station/command/heads_quarters/blueshield)
"o" = (
/obj/machinery/computer/crew{
	dir = 4
	},
/obj/structure/sign/calendar/directional/north,
/obj/structure/extinguisher_cabinet/directional/west,
/turf/open/floor/carpet/blue,
/area/station/command/heads_quarters/blueshield)
"p" = (
/obj/machinery/atmospherics/pipe/smart/manifold4w/supply/hidden/layer4,
/obj/effect/landmark/start/blueshield,
/obj/structure/cable,
/obj/effect/turf_decal/tile/blue/diagonal_centre,
/obj/machinery/vending/wallmed/directional/north,
/turf/open/floor/iron/dark/diagonal,
/area/station/command/heads_quarters/blueshield)
"s" = (
/obj/machinery/door/firedoor,
/obj/machinery/atmospherics/pipe/smart/manifold4w/supply/hidden/layer4,
/obj/machinery/atmospherics/pipe/smart/manifold4w/scrubbers/hidden/layer2,
/obj/effect/mapping_helpers/airlock/access/all/cent_com/blueshield,
/obj/machinery/door/airlock/highsecurity{
	name = "Blueshield's Armory"
	},
/obj/structure/cable,
/turf/open/floor/iron/dark/textured_large,
/area/station/command/heads_quarters/blueshield)
"t" = (
/obj/structure/rack/shelf,
/obj/machinery/power/apc/auto_name/directional/south,
/obj/structure/cable,
/obj/item/storage/toolbox/ammobox/wt550m9,
/turf/open/floor/iron/dark/small,
/area/station/command/heads_quarters/blueshield)
"w" = (
/obj/effect/spawner/structure/window/reinforced,
/obj/structure/cable,
/obj/machinery/door/poddoor/shutters/preopen{
	id = "blueshield_priv";
	name = "Privacy Shutters";
	dir = 4
	},
/turf/open/floor/plating,
/area/station/command/heads_quarters/blueshield)
"x" = (
/obj/machinery/light/small/directional/east,
/obj/machinery/atmospherics/components/unary/vent_pump/on/layer4{
	dir = 8
	},
/obj/effect/turf_decal/tile/blue/diagonal_centre,
/obj/structure/sign/poster/official/enlist/directional/east,
/turf/open/floor/iron/dark/diagonal,
/area/station/command/heads_quarters/blueshield)
"z" = (
/obj/structure/closet/secure_closet/tac{
	req_access = list("cent_officer")
	},
/obj/item/clothing/suit/armor/riot,
/obj/item/clothing/head/helmet/toggleable/riot,
/obj/machinery/status_display/ai/directional/south,
/obj/machinery/light/red/directional/south,
/obj/structure/sign/poster/official/nanotrasen_logo/directional/west,
/turf/open/floor/iron/dark/small,
/area/station/command/heads_quarters/blueshield)
"A" = (
/obj/structure/cable,
/obj/machinery/atmospherics/pipe/smart/manifold4w/scrubbers/hidden/layer2,
/obj/machinery/atmospherics/pipe/smart/manifold4w/supply/hidden/layer4,
/obj/machinery/light_switch/directional/south,
/obj/effect/turf_decal/siding/wood/end{
	dir = 4
	},
/turf/open/floor/wood/parquet,
/area/station/command/heads_quarters/blueshield)
"D" = (
/obj/machinery/modular_computer/preset/command{
	dir = 4
	},
/obj/machinery/status_display/evac/directional/west,
/obj/machinery/light/directional/west,
/turf/open/floor/carpet/blue,
/area/station/command/heads_quarters/blueshield)
"F" = (
/obj/machinery/door/firedoor,
/obj/structure/cable,
/obj/machinery/atmospherics/pipe/smart/manifold4w/supply/hidden/layer4,
/obj/machinery/atmospherics/pipe/smart/manifold4w/scrubbers/hidden/layer2,
/obj/effect/mapping_helpers/airlock/access/all/cent_com/blueshield,
/obj/machinery/door/airlock/corporate{
	name = "Blueshield's Office"
	},
/turf/open/floor/iron/dark/textured_large,
/area/station/command/heads_quarters/blueshield)
"I" = (
/obj/machinery/airalarm/directional/west,
/obj/machinery/computer/security{
	dir = 4
	},
/turf/open/floor/carpet/blue,
/area/station/command/heads_quarters/blueshield)
"J" = (
/obj/machinery/airalarm/directional/south,
/obj/structure/closet/secure_closet/blueshield,
/obj/machinery/camera/directional/south{
	c_tag = "Bridge - Blueshield's Armory"
	},
/turf/open/floor/iron/dark/small,
/area/station/command/heads_quarters/blueshield)
"K" = (
/obj/effect/turf_decal/siding/wood{
	dir = 1
	},
/obj/machinery/firealarm/directional/south,
/obj/structure/cable,
/obj/machinery/atmospherics/pipe/smart/manifold4w/supply/hidden/layer4,
/obj/machinery/atmospherics/pipe/smart/manifold4w/scrubbers/hidden/layer2,
/obj/effect/turf_decal/siding/wood,
/obj/machinery/holopad,
/obj/effect/landmark/event_spawn,
/turf/open/floor/wood/parquet,
/area/station/command/heads_quarters/blueshield)
"M" = (
/obj/structure/rack/shelf,
/obj/item/storage/medkit/brute,
/obj/item/storage/medkit/fire{
	pixel_y = 4
	},
/obj/machinery/status_display/ai/directional/south,
/obj/machinery/light/red/directional/south,
/turf/open/floor/iron/dark/small,
/area/station/command/heads_quarters/blueshield)
"N" = (
/obj/structure/chair/comfy/black{
	dir = 8
	},
/obj/effect/landmark/start/blueshield,
/turf/open/floor/carpet/blue,
/area/station/command/heads_quarters/blueshield)
"Q" = (
/obj/effect/spawner/structure/window/reinforced,
/obj/structure/cable,
/obj/machinery/door/poddoor/shutters/preopen{
	id = "blueshield_priv";
	name = "Privacy Shutters";
	dir = 1
	},
/turf/open/floor/plating,
/area/station/command/heads_quarters/blueshield)
"T" = (
/turf/open/floor/carpet/blue,
/area/station/command/heads_quarters/blueshield)
"V" = (
/obj/machinery/atmospherics/components/unary/vent_pump/on/layer4,
/obj/machinery/atmospherics/pipe/smart/manifold4w/scrubbers/hidden/layer2,
/obj/structure/bed/dogbed{
	anchored = 1;
	name = "Walter's bed"
	},
/mob/living/basic/pet/dog/dobermann/walter,
/turf/open/floor/carpet/blue,
/area/station/command/heads_quarters/blueshield)
"W" = (
/turf/closed/wall/r_wall,
/area/station/command/heads_quarters/blueshield)
"X" = (
/obj/machinery/light/warm/directional/east,
/obj/machinery/camera/directional/north{
	c_tag = "Bridge - Blueshield's Office"
	},
/obj/machinery/newscaster/directional/north,
/obj/machinery/button/curtain{
	id = "blueshield";
	pixel_x = 24
	},
/obj/machinery/button/door/directional/east{
	id = "blueshield_priv";
	name = "Privacy Shutters Control"
	},
/obj/structure/grandfatherclock,
/turf/open/floor/carpet/blue,
/area/station/command/heads_quarters/blueshield)
"Y" = (
/obj/effect/turf_decal/siding/wood{
	dir = 1
	},
/obj/structure/cable,
/obj/machinery/atmospherics/pipe/smart/manifold4w/supply/hidden/layer4,
/obj/machinery/atmospherics/pipe/smart/manifold4w/scrubbers/hidden/layer2,
/obj/effect/turf_decal/siding/wood,
/obj/machinery/light/directional/south,
/obj/effect/mapping_helpers/turn_off_lights_with_lightswitch,
/turf/open/floor/wood/parquet,
/area/station/command/heads_quarters/blueshield)
"Z" = (
/obj/machinery/door/firedoor,
/obj/machinery/atmospherics/pipe/smart/manifold4w/scrubbers/hidden/layer2,
/obj/machinery/atmospherics/pipe/smart/manifold4w/supply/hidden/layer4,
/obj/effect/mapping_helpers/airlock/access/all/cent_com/blueshield,
/obj/machinery/door/airlock/corporate{
	name = "Blueshield's Office"
	},
/obj/effect/landmark/navigate_destination/autoname,
/turf/open/floor/iron/dark/textured_large,
/area/station/command/heads_quarters/blueshield)

(1,1,1) = {"
a
a
a
W
W
W
a
a
a
"}
(2,1,1) = {"
W
W
W
W
l
F
a
a
a
"}
(3,1,1) = {"
W
o
D
I
h
W
a
a
a
"}
(4,1,1) = {"
W
X
N
T
K
W
W
W
W
"}
(5,1,1) = {"
W
W
e
T
Y
W
f
z
W
"}
(6,1,1) = {"
a
Q
c
V
d
s
j
J
W
"}
(7,1,1) = {"
a
Q
w
w
A
W
p
t
W
"}
(8,1,1) = {"
a
a
a
W
Z
W
x
M
W
"}
(9,1,1) = {"
a
a
a
a
a
W
W
W
W
"}
