//MAP CONVERTED BY dmm2tgm.py THIS HEADER COMMENT PREVENTS RECONVERSION, DO NOT REMOVE
"a" = (
/obj/machinery/light/cold/directional/north,
/obj/structure/table/optable,
/obj/machinery/vitals_reader/directional/north,
/obj/effect/turf_decal/trimline/blue/filled/line{
	dir = 1
	},
/obj/machinery/atmospherics/components/unary/vent_scrubber/on/layer2,
/turf/open/floor/iron/white,
/area/station/security/medical)
"h" = (
/obj/effect/turf_decal/tile/blue,
/obj/structure/cable,
/obj/structure/chair/office/light{
	dir = 8
	},
/turf/open/floor/iron/white,
/area/station/security/medical)
"k" = (
/obj/machinery/door/window/brigdoor/left/directional/south{
	name = "Security Medical";
	req_access = list("brig")
	},
/obj/effect/turf_decal/trimline/blue/filled/corner,
/obj/effect/turf_decal/trimline/blue/filled/corner{
	dir = 8
	},
/obj/effect/turf_decal/tile/blue{
	dir = 1
	},
/obj/machinery/atmospherics/pipe/smart/manifold4w/supply/hidden/layer4,
/obj/machinery/atmospherics/pipe/smart/manifold4w/scrubbers/hidden/layer2,
/obj/structure/cable,
/obj/machinery/door/firedoor/border_only{
	pixel_x = 0;
	pixel_y = -1
	},
/turf/open/floor/iron/white,
/area/station/security/medical)
"q" = (
/obj/structure/window/reinforced/spawner/directional/south,
/obj/structure/closet/secure_closet/security_medic,
/obj/effect/turf_decal/trimline/blue/filled/line{
	dir = 6
	},
/turf/open/floor/iron/white,
/area/station/security/medical)
"x" = (
/obj/structure/window/reinforced/spawner/directional/south,
/obj/structure/window/reinforced/spawner/directional/west,
/obj/structure/table/reinforced,
/obj/item/storage/box/bandages{
	pixel_x = -3;
	pixel_y = 0
	},
/obj/item/storage/medkit/regular{
	pixel_x = 1;
	pixel_y = 13
	},
/obj/item/reagent_containers/spray/cleaner{
	pixel_x = 14;
	pixel_y = 4
	},
/obj/effect/turf_decal/trimline/blue/filled/line{
	dir = 10
	},
/turf/open/floor/iron/white,
/area/station/security/medical)
"z" = (
/turf/closed/wall/r_wall,
/area/station/security/medical)
"A" = (
/obj/effect/turf_decal/tile/blue,
/obj/effect/turf_decal/tile/blue{
	dir = 8
	},
/obj/effect/turf_decal/tile/blue{
	dir = 1
	},
/obj/machinery/atmospherics/pipe/smart/manifold4w/supply/hidden/layer4,
/obj/machinery/atmospherics/pipe/smart/manifold4w/scrubbers/hidden/layer2,
/obj/structure/cable,
/obj/effect/landmark/event_spawn,
/turf/open/floor/iron/white,
/area/station/security/medical)
"B" = (
/obj/structure/window/reinforced/spawner/directional/south,
/obj/structure/table/reinforced,
/obj/machinery/computer/crew{
	dir = 1
	},
/obj/effect/turf_decal/trimline/blue/filled/line,
/turf/open/floor/iron/white,
/area/station/security/medical)
"D" = (
/turf/closed/wall/r_wall,
/area/station/security/prison)
"M" = (
/turf/closed/wall,
/area/station/security/medical)
"N" = (
/obj/machinery/stasis,
/obj/machinery/firealarm/directional/east,
/obj/item/bedsheet/medical,
/obj/machinery/iv_drip,
/obj/effect/turf_decal/trimline/blue/filled/line{
	dir = 4
	},
/obj/machinery/atmospherics/pipe/smart/manifold4w/supply/hidden/layer4,
/turf/open/floor/iron/white,
/area/station/security/medical)
"P" = (
/obj/machinery/camera/directional/north{
	c_tag = "Security - Infirmary"
	},
/obj/machinery/computer/operating,
/obj/structure/table/reinforced,
/obj/machinery/power/apc/auto_name/directional/north,
/obj/effect/turf_decal/trimline/blue/filled/line{
	dir = 1
	},
/obj/structure/cable,
/turf/open/floor/iron/white,
/area/station/security/medical)
"T" = (
/obj/effect/spawner/surgery_tray/full/deployed,
/obj/machinery/defibrillator_mount/directional/north,
/obj/structure/sign/poster/official/moth_epi/directional/east,
/obj/effect/turf_decal/trimline/blue/filled/line{
	dir = 5
	},
/obj/machinery/atmospherics/components/unary/vent_pump/on/layer4,
/turf/open/floor/iron/white,
/area/station/security/medical)
"V" = (
/obj/structure/window/reinforced/spawner/directional/west,
/obj/structure/table/reinforced,
/obj/machinery/computer/records/medical/laptop{
	dir = 4;
	pixel_x = 4;
	pixel_y = 2
	},
/obj/item/reagent_containers/syringe{
	pixel_x = -2;
	pixel_y = 14
	},
/obj/effect/turf_decal/trimline/blue/filled/line{
	dir = 8
	},
/turf/open/floor/iron/white,
/area/station/security/medical)
"Z" = (
/obj/structure/window/reinforced/spawner/directional/west,
/obj/structure/table/reinforced,
/obj/machinery/airalarm/directional/north,
/obj/item/folder/red{
	pixel_x = 10;
	pixel_y = 4
	},
/obj/item/folder/white{
	pixel_x = 10;
	pixel_y = 8
	},
/obj/item/paper_bin{
	pixel_x = -3;
	pixel_y = 9
	},
/obj/item/pen{
	pixel_x = -3;
	pixel_y = 10
	},
/obj/item/reagent_containers/cup/bottle/epinephrine{
	pixel_x = -4;
	pixel_y = -7
	},
/obj/item/reagent_containers/cup/bottle/multiver{
	pixel_x = 2;
	pixel_y = -7
	},
/obj/effect/turf_decal/trimline/blue/filled/line{
	dir = 9
	},
/turf/open/floor/iron/white,
/area/station/security/medical)

(1,1,1) = {"
M
Z
V
x
"}
(2,1,1) = {"
z
P
h
B
"}
(3,1,1) = {"
z
a
A
k
"}
(4,1,1) = {"
z
T
N
q
"}
(5,1,1) = {"
D
D
D
D
"}
