//MAP CONVERTED BY dmm2tgm.py THIS HEADER COMMENT PREVENTS RECONVERSION, DO NOT REMOVE
"a" = (
/obj/effect/turf_decal/siding/wood{
	dir = 5
	},
/obj/structure/table/wood,
/obj/item/clipboard{
	pixel_y = 3;
	pixel_x = 2
	},
/obj/item/folder/yellow{
	pixel_y = 1;
	pixel_x = -2
	},
/turf/open/floor/wood/large,
/area/station/command/heads_quarters/nt_rep)
"b" = (
/obj/structure/sign/flag/nanotrasen/directional/north,
/obj/machinery/holopad/secure,
/obj/structure/cable,
/obj/effect/turf_decal/siding/wood{
	dir = 5
	},
/turf/open/floor/wood,
/area/station/command/heads_quarters/nt_rep)
"d" = (
/obj/machinery/atmospherics/pipe/smart/manifold4w/supply/hidden/layer4,
/obj/effect/turf_decal/siding/wood{
	dir = 1
	},
/obj/effect/turf_decal/siding/wood{
	dir = 1
	},
/turf/open/floor/wood,
/area/station/command/heads_quarters/nt_rep)
"f" = (
/obj/structure/extinguisher_cabinet/directional/west,
/obj/machinery/camera/directional/west{
	c_tag = "Bridge - Consultant Office"
	},
/obj/structure/displaycase/trophy,
/turf/open/floor/carpet/executive,
/area/station/command/heads_quarters/nt_rep)
"g" = (
/obj/effect/turf_decal/siding/wood{
	dir = 1
	},
/obj/structure/table/wood,
/obj/item/paper_bin{
	pixel_y = 5;
	pixel_x = -4
	},
/obj/item/pen{
	pixel_y = 5;
	pixel_x = -4
	},
/obj/item/stamp/granted{
	pixel_y = 8;
	pixel_x = 8
	},
/obj/item/stamp/denied{
	pixel_x = 8;
	pixel_y = 2
	},
/turf/open/floor/wood/large,
/area/station/command/heads_quarters/nt_rep)
"h" = (
/obj/effect/turf_decal/siding/wood,
/obj/machinery/requests_console/auto_name/directional/south,
/turf/open/floor/wood,
/area/station/command/heads_quarters/nt_rep)
"i" = (
/obj/effect/turf_decal/siding/wood{
	dir = 9
	},
/obj/machinery/firealarm/directional/north,
/obj/machinery/light/warm/directional/north,
/obj/structure/cable,
/turf/open/floor/wood,
/area/station/command/heads_quarters/nt_rep)
"j" = (
/obj/structure/filingcabinet/employment,
/obj/effect/turf_decal/stripes/line{
	dir = 8
	},
/obj/effect/turf_decal/bot,
/obj/structure/cable,
/obj/structure/filingcabinet/security{
	pixel_x = 10;
	icon_state = "employmentcabinet";
	name = "security records filing cabinet"
	},
/obj/structure/filingcabinet/medical{
	pixel_x = -10;
	icon_state = "employmentcabinet";
	name = "medical records filing cabinet"
	},
/turf/open/floor/iron/dark/smooth_large,
/area/station/command/heads_quarters/nt_rep)
"k" = (
/obj/effect/turf_decal/siding/wood{
	dir = 4
	},
/turf/open/floor/wood,
/area/station/command/heads_quarters/nt_rep)
"n" = (
/obj/machinery/atmospherics/components/unary/vent_pump/on/layer4{
	dir = 8
	},
/obj/effect/turf_decal/siding/wood{
	dir = 1
	},
/obj/machinery/keycard_auth/wall_mounted/directional/north,
/turf/open/floor/wood,
/area/station/command/heads_quarters/nt_rep)
"o" = (
/obj/effect/turf_decal/siding/wood{
	dir = 1
	},
/obj/structure/closet/secure_closet/nanotrasen_crew_trainer,
/turf/open/floor/wood,
/area/station/command/heads_quarters/nt_rep)
"q" = (
/obj/machinery/airalarm/directional/north,
/obj/machinery/photocopier/prebuilt,
/obj/effect/turf_decal/stripes/line,
/obj/effect/turf_decal/bot,
/obj/machinery/button/door/directional/east{
	id = "consultantprivacy";
	name = "Privacy Shutters Control";
	pixel_y = 24
	},
/turf/open/floor/iron/dark/smooth_large,
/area/station/command/heads_quarters/nt_rep)
"r" = (
/obj/machinery/power/apc/auto_name/directional/west,
/obj/item/kirbyplants/organic/plant22,
/obj/structure/cable,
/obj/machinery/light/warm/directional/west,
/turf/open/floor/carpet/executive,
/area/station/command/heads_quarters/nt_rep)
"u" = (
/obj/machinery/atmospherics/pipe/smart/manifold4w/supply/hidden/layer4,
/obj/effect/turf_decal/siding/wood{
	dir = 1
	},
/turf/open/floor/wood,
/area/station/command/heads_quarters/nt_rep)
"w" = (
/obj/effect/turf_decal/siding/wood{
	dir = 10
	},
/obj/structure/disposalpipe/segment{
	dir = 10
	},
/obj/structure/cable,
/obj/machinery/atmospherics/pipe/smart/manifold4w/supply/hidden/layer4,
/obj/machinery/atmospherics/pipe/smart/manifold4w/scrubbers/hidden/layer2,
/turf/open/floor/wood,
/area/station/command/heads_quarters/nt_rep)
"x" = (
/obj/effect/turf_decal/siding/wood{
	dir = 8
	},
/obj/structure/cable,
/obj/machinery/atmospherics/pipe/smart/manifold4w/supply/hidden/layer4,
/obj/machinery/atmospherics/pipe/smart/manifold4w/scrubbers/hidden/layer2,
/turf/open/floor/wood,
/area/station/command/heads_quarters/nt_rep)
"y" = (
/obj/effect/spawner/structure/window/reinforced,
/obj/structure/cable,
/obj/machinery/door/poddoor/shutters/preopen{
	dir = 4;
	id = "consultantprivacy";
	name = "Privacy Shutters"
	},
/turf/open/floor/plating,
/area/station/command/heads_quarters/nt_rep)
"z" = (
/obj/effect/turf_decal/siding/wood/corner{
	dir = 8
	},
/obj/effect/landmark/start/nanotrasen_crew_trainer,
/turf/open/floor/wood,
/area/station/command/heads_quarters/nt_rep)
"A" = (
/obj/structure/aquarium/prefilled,
/obj/item/reagent_containers/cup/fish_feed{
	pixel_x = 6;
	pixel_y = 19
	},
/obj/item/toy/figure/dsquad{
	pixel_x = -10;
	pixel_y = 16
	},
/turf/open/floor/carpet/executive,
/area/station/command/heads_quarters/nt_rep)
"B" = (
/obj/structure/disposalpipe/segment,
/obj/structure/cable,
/obj/machinery/atmospherics/pipe/smart/manifold4w/supply/hidden/layer4,
/obj/machinery/atmospherics/pipe/smart/manifold4w/scrubbers/hidden/layer2,
/obj/machinery/door/airlock/corporate{
	name = "Consultant's Office"
	},
/obj/machinery/door/firedoor,
/obj/effect/mapping_helpers/airlock/access/any/cent_com/rep_or_captain,
/turf/open/floor/iron/dark/smooth_large,
/area/station/command/heads_quarters/nt_rep)
"C" = (
/obj/machinery/newscaster/directional/south,
/obj/effect/turf_decal/siding/wood,
/turf/open/floor/wood,
/area/station/command/heads_quarters/nt_rep)
"D" = (
/obj/structure/table/reinforced/titaniumglass,
/obj/item/paper_bin{
	pixel_y = 5;
	pixel_x = -4
	},
/obj/item/pen/fountain/nanotrasen{
	pixel_y = 5;
	pixel_x = -4
	},
/obj/item/stamp/granted{
	pixel_y = 12;
	pixel_x = 8
	},
/obj/item/stamp/denied{
	pixel_x = 8;
	pixel_y = 6
	},
/obj/item/stamp/nanotrasen{
	pixel_x = 8
	},
/turf/open/floor/carpet/executive,
/area/station/command/heads_quarters/nt_rep)
"E" = (
/obj/effect/turf_decal/stripes/line,
/obj/structure/table/wood/fancy/blue,
/obj/machinery/fax{
	fax_name = "Nanotrasen Consultant's Office";
	name = "Nanotrasen Consultant's Fax Machine"
	},
/turf/open/floor/iron/dark/smooth_large,
/area/station/command/heads_quarters/nt_rep)
"G" = (
/obj/machinery/atmospherics/pipe/smart/manifold4w/scrubbers/hidden/layer2,
/obj/effect/turf_decal/siding/wood{
	dir = 4
	},
/obj/effect/landmark/start/nanotrasen_crew_trainer,
/turf/open/floor/wood,
/area/station/command/heads_quarters/nt_rep)
"H" = (
/turf/closed/wall/r_wall,
/area/station/command/heads_quarters/nt_rep)
"J" = (
/turf/template_noop,
/area/template_noop)
"L" = (
/obj/structure/table/reinforced/titaniumglass,
/obj/item/clipboard{
	pixel_y = 2;
	pixel_x = 7
	},
/obj/item/folder/blue{
	pixel_y = 1;
	pixel_x = 6
	},
/obj/item/reagent_containers/cup/glass/mug/nanotrasen{
	pixel_x = 12;
	pixel_y = 12
	},
/obj/item/sign/flag/nanotrasen{
	pixel_y = -2;
	pixel_x = 7
	},
/obj/machinery/recharger{
	pixel_y = 3;
	pixel_x = -6
	},
/turf/open/floor/carpet/executive,
/area/station/command/heads_quarters/nt_rep)
"M" = (
/obj/machinery/atmospherics/pipe/smart/manifold4w/supply/hidden/layer4,
/obj/effect/turf_decal/siding/wood/corner{
	dir = 4
	},
/turf/open/floor/wood,
/area/station/command/heads_quarters/nt_rep)
"N" = (
/obj/structure/closet/secure_closet/nanotrasen_consultant,
/obj/effect/turf_decal/siding/wood{
	dir = 5
	},
/turf/open/floor/wood,
/area/station/command/heads_quarters/nt_rep)
"O" = (
/obj/machinery/camera/autoname/directional/west,
/obj/effect/turf_decal/siding/wood{
	dir = 10
	},
/obj/machinery/computer/station_goal{
	dir = 1
	},
/turf/open/floor/wood,
/area/station/command/heads_quarters/nt_rep)
"R" = (
/obj/effect/turf_decal/siding/wood,
/turf/open/floor/wood,
/area/station/command/heads_quarters/nt_rep)
"S" = (
/obj/structure/chair/office,
/turf/open/floor/wood,
/area/station/command/heads_quarters/nt_rep)
"T" = (
/obj/structure/cable,
/obj/structure/safe/floor,
/obj/item/clothing/accessory/medal/gold/ordom,
/obj/item/clothing/accessory/medal/silver/bureaucracy,
/obj/item/clothing/accessory/medal/gold/nanotrasen_consultant,
/turf/open/floor/carpet/executive,
/area/station/command/heads_quarters/nt_rep)
"U" = (
/obj/structure/cable,
/obj/structure/chair/comfy/brown,
/obj/effect/landmark/start/nanotrasen_consultant,
/turf/open/floor/carpet/executive,
/area/station/command/heads_quarters/nt_rep)
"V" = (
/obj/effect/turf_decal/stripes/line{
	dir = 5
	},
/obj/machinery/disposal/bin,
/obj/effect/turf_decal/box,
/obj/structure/disposalpipe/trunk{
	dir = 4
	},
/obj/machinery/light_switch/directional/west,
/turf/open/floor/iron/dark/smooth_large,
/area/station/command/heads_quarters/nt_rep)
"W" = (
/obj/effect/turf_decal/siding/wood{
	dir = 8
	},
/obj/structure/cable,
/obj/machinery/atmospherics/pipe/smart/manifold4w/scrubbers/hidden/layer2,
/obj/machinery/atmospherics/components/unary/vent_pump/on/layer4,
/turf/open/floor/wood,
/area/station/command/heads_quarters/nt_rep)
"Y" = (
/turf/closed/wall/r_wall,
/area/station/maintenance/central/lesser)

(1,1,1) = {"
J
H
H
H
H
H
H
J
"}
(2,1,1) = {"
J
H
A
r
f
V
H
J
"}
(3,1,1) = {"
J
H
i
W
x
w
B
J
"}
(4,1,1) = {"
H
H
b
G
M
h
H
H
"}
(5,1,1) = {"
H
q
T
D
d
C
H
H
"}
(6,1,1) = {"
H
E
U
L
u
R
H
H
"}
(7,1,1) = {"
y
y
j
H
n
z
O
H
"}
(8,1,1) = {"
J
y
y
H
o
S
g
H
"}
(9,1,1) = {"
J
J
J
H
N
k
a
H
"}
(10,1,1) = {"
J
J
J
Y
Y
Y
Y
Y
"}
