//MAP CONVERTED BY dmm2tgm.py THIS HEADER COMMENT PREVENTS RECONVERSION, DO NOT REMOVE
"a" = (
/turf/open/moving/auto_icon/groups/group_10,
/area/trainstation/outdoor/rails)
"c" = (
/turf/open/moving/auto_icon/groups/group_17{
	fake = 1
	},
/area/trainstation/outdoor/rails)
"e" = (
/obj/effect/landmark/trainstation/object_spawner/center,
/turf/open/moving/auto_icon/groups/group_7,
/area/trainstation/outdoor/rails)
"f" = (
/turf/open/moving/auto_icon/groups/group_12{
	fake = 1;
	density = 1
	},
/area/trainstation/outdoor/rails)
"h" = (
/turf/open/moving/auto_icon/groups/group_15{
	fake = 1
	},
/area/trainstation/outdoor/rails)
"i" = (
/turf/open/moving/auto_icon/groups/group_3,
/area/trainstation/outdoor/rails)
"k" = (
/turf/open/moving/auto_icon/groups/group_13{
	fake = 1
	},
/area/trainstation/outdoor/rails)
"l" = (
/obj/effect/landmark/trainstation/object_spawner/center,
/turf/open/moving/auto_icon/groups/group_6,
/area/trainstation/outdoor/rails)
"n" = (
/turf/open/moving/auto_icon/groups/group_16{
	fake = 1
	},
/area/trainstation/outdoor/rails)
"q" = (
/obj/effect/landmark/trainstation/object_spawner/backdrop,
/turf/open/moving/auto_icon/groups/group_6,
/area/trainstation/outdoor/rails)
"r" = (
/turf/open/moving/auto_icon/groups/group_2,
/area/trainstation/outdoor/rails)
"s" = (
/obj/effect/landmark/trainstation/object_spawner/near_rails_secondnary,
/turf/open/moving/auto_icon/groups/group_2,
/area/trainstation/outdoor/rails)
"t" = (
/turf/open/moving/auto_icon/groups/group_1,
/area/trainstation/outdoor/rails)
"u" = (
/turf/open/moving/auto_icon/groups/group_6,
/area/trainstation/outdoor/rails)
"w" = (
/obj/effect/landmark/trainstation/object_spawner/backdrop,
/turf/open/moving/auto_icon/groups/group_4,
/area/trainstation/outdoor/rails)
"x" = (
/turf/open/moving/auto_icon/groups/group_5,
/area/trainstation/outdoor/rails)
"y" = (
/turf/open/moving/auto_icon/groups/group_7,
/area/trainstation/outdoor/rails)
"B" = (
/turf/open/moving/auto_icon/groups/group_18{
	fake = 1;
	opacity = 1
	},
/area/trainstation/outdoor/rails)
"C" = (
/obj/effect/landmark/trainstation/object_spawner/near_rails,
/turf/open/moving/auto_icon/groups/group_3,
/area/trainstation/outdoor/rails)
"D" = (
/turf/open/moving/auto_icon/groups/group_4,
/area/trainstation/outdoor/rails)
"G" = (
/obj/effect/landmark/trainstation/object_spawner/foreign_special,
/turf/open/moving/auto_icon/groups/group_10,
/area/trainstation/outdoor/rails)
"H" = (
/turf/open/moving/auto_icon/groups/group_9,
/area/trainstation/outdoor/rails)
"J" = (
/turf/open/moving/auto_icon/groups/group_14{
	fake = 1
	},
/area/trainstation/outdoor/rails)
"L" = (
/turf/open/moving/auto_icon/groups/group_8,
/area/trainstation/outdoor/rails)
"O" = (
/turf/open/moving/auto_icon/groups/group_11,
/area/trainstation/outdoor/rails)
"V" = (
/obj/effect/landmark/trainstation/object_spawner/center_special,
/turf/open/moving/auto_icon/groups/group_7,
/area/trainstation/outdoor/rails)
"X" = (
/obj/effect/landmark/trainstation/object_spawner/foreign,
/turf/open/moving/auto_icon/groups/group_9,
/area/trainstation/outdoor/rails)
"Y" = (
/obj/effect/landmark/trainstation/object_spawner/center,
/turf/open/moving/auto_icon/groups/group_5,
/area/trainstation/outdoor/rails)
"Z" = (
/obj/effect/landmark/trainstation/object_spawner/backdrop,
/turf/open/moving/auto_icon/groups/group_8,
/area/trainstation/outdoor/rails)

(1,1,1) = {"
t
r
i
D
x
u
y
L
H
a
O
O
f
f
k
k
J
J
h
h
n
n
c
c
B
"}
(2,1,1) = {"
t
r
i
D
x
u
y
L
H
a
O
O
f
f
k
k
J
J
h
h
n
n
c
c
B
"}
(3,1,1) = {"
t
r
i
D
x
u
y
L
H
a
O
O
f
f
k
k
J
J
h
h
n
n
c
c
B
"}
(4,1,1) = {"
t
r
i
D
x
u
y
L
H
a
O
O
f
f
k
k
J
J
h
h
n
n
c
c
B
"}
(5,1,1) = {"
t
r
i
D
x
u
y
L
H
a
O
O
f
f
k
k
J
J
h
h
n
n
c
c
B
"}
(6,1,1) = {"
t
r
i
D
x
u
y
L
H
a
O
O
f
f
k
k
J
J
h
h
n
n
c
c
B
"}
(7,1,1) = {"
t
r
i
D
x
u
y
L
H
a
O
O
f
f
k
k
J
J
h
h
n
n
c
c
B
"}
(8,1,1) = {"
t
r
i
D
x
u
y
L
H
a
O
O
f
f
k
k
J
J
h
h
n
n
c
c
B
"}
(9,1,1) = {"
t
r
i
D
x
u
y
L
H
a
O
O
f
f
k
k
J
J
h
h
n
n
c
c
B
"}
(10,1,1) = {"
t
r
i
D
x
u
y
L
H
a
O
O
f
f
k
k
J
J
h
h
n
n
c
c
B
"}
(11,1,1) = {"
t
r
i
D
x
u
y
L
H
a
O
O
f
f
k
k
J
J
h
h
n
n
c
c
B
"}
(12,1,1) = {"
t
r
i
D
x
u
y
L
H
a
O
O
f
f
k
k
J
J
h
h
n
n
c
c
B
"}
(13,1,1) = {"
t
r
i
D
x
u
y
L
H
a
O
O
f
f
k
k
J
J
h
h
n
n
c
c
B
"}
(14,1,1) = {"
t
r
i
D
x
u
y
L
H
a
O
O
f
f
k
k
J
J
h
h
n
n
c
c
B
"}
(15,1,1) = {"
t
r
i
D
x
u
y
L
H
a
O
O
f
f
k
k
J
J
h
h
n
n
c
c
B
"}
(16,1,1) = {"
t
r
i
D
x
u
y
L
H
a
O
O
f
f
k
k
J
J
h
h
n
n
c
c
B
"}
(17,1,1) = {"
t
r
i
D
x
u
y
L
H
a
O
O
f
f
k
k
J
J
h
h
n
n
c
c
B
"}
(18,1,1) = {"
t
r
i
D
x
u
y
L
H
a
O
O
f
f
k
k
J
J
h
h
n
n
c
c
B
"}
(19,1,1) = {"
t
r
i
D
x
u
y
L
H
a
O
O
f
f
k
k
J
J
h
h
n
n
c
c
B
"}
(20,1,1) = {"
t
r
i
D
x
u
y
L
H
a
O
O
f
f
k
k
J
J
h
h
n
n
c
c
B
"}
(21,1,1) = {"
t
r
i
D
x
u
y
L
H
a
O
O
f
f
k
k
J
J
h
h
n
n
c
c
B
"}
(22,1,1) = {"
t
r
i
D
x
u
y
L
H
a
O
O
f
f
k
k
J
J
h
h
n
n
c
c
B
"}
(23,1,1) = {"
t
r
i
D
x
u
y
L
H
a
O
O
f
f
k
k
J
J
h
h
n
n
c
c
B
"}
(24,1,1) = {"
t
r
i
D
x
u
y
L
H
a
O
O
f
f
k
k
J
J
h
h
n
n
c
c
B
"}
(25,1,1) = {"
t
r
i
D
x
u
y
L
H
a
O
O
f
f
k
k
J
J
h
h
n
n
c
c
B
"}
(26,1,1) = {"
t
r
i
D
x
u
y
L
H
a
O
O
f
f
k
k
J
J
h
h
n
n
c
c
B
"}
(27,1,1) = {"
t
r
i
D
x
u
y
L
H
a
O
O
f
f
k
k
J
J
h
h
n
n
c
c
B
"}
(28,1,1) = {"
t
r
i
D
x
u
y
L
H
a
O
O
f
f
k
k
J
J
h
h
n
n
c
c
B
"}
(29,1,1) = {"
t
r
i
D
x
u
y
L
H
a
O
O
f
f
k
k
J
J
h
h
n
n
c
c
B
"}
(30,1,1) = {"
t
r
i
D
x
u
y
L
H
a
O
O
f
f
k
k
J
J
h
h
n
n
c
c
B
"}
(31,1,1) = {"
t
r
i
D
x
u
y
L
H
a
O
O
f
f
k
k
J
J
h
h
n
n
c
c
B
"}
(32,1,1) = {"
t
r
i
D
x
u
y
L
H
a
O
O
f
f
k
k
J
J
h
h
n
n
c
c
B
"}
(33,1,1) = {"
t
r
i
D
x
u
y
L
H
a
O
O
f
f
k
k
J
J
h
h
n
n
c
c
B
"}
(34,1,1) = {"
t
r
i
D
x
u
y
L
H
a
O
O
f
f
k
k
J
J
h
h
n
n
c
c
B
"}
(35,1,1) = {"
t
r
i
D
x
u
y
L
H
a
O
O
f
f
k
k
J
J
h
h
n
n
c
c
B
"}
(36,1,1) = {"
t
r
i
D
x
u
y
L
H
a
O
O
f
f
k
k
J
J
h
h
n
n
c
c
B
"}
(37,1,1) = {"
t
r
i
D
x
u
y
L
H
a
O
O
f
f
k
k
J
J
h
h
n
n
c
c
B
"}
(38,1,1) = {"
t
r
i
D
x
u
y
L
H
a
O
O
f
f
k
k
J
J
h
h
n
n
c
c
B
"}
(39,1,1) = {"
t
r
i
D
x
u
y
L
H
a
O
O
f
f
k
k
J
J
h
h
n
n
c
c
B
"}
(40,1,1) = {"
t
r
i
D
x
u
y
L
H
a
O
O
f
f
k
k
J
J
h
h
n
n
c
c
B
"}
(41,1,1) = {"
t
r
i
D
x
u
y
L
H
a
O
O
f
f
k
k
J
J
h
h
n
n
c
c
B
"}
(42,1,1) = {"
t
r
i
D
x
u
y
L
H
a
O
O
f
f
k
k
J
J
h
h
n
n
c
c
B
"}
(43,1,1) = {"
t
r
i
D
x
u
y
L
H
a
O
O
f
f
k
k
J
J
h
h
n
n
c
c
B
"}
(44,1,1) = {"
t
r
i
D
x
u
y
L
H
a
O
O
f
f
k
k
J
J
h
h
n
n
c
c
B
"}
(45,1,1) = {"
t
r
i
D
x
u
y
L
H
a
O
O
f
f
k
k
J
J
h
h
n
n
c
c
B
"}
(46,1,1) = {"
t
r
i
D
x
u
y
L
H
a
O
O
f
f
k
k
J
J
h
h
n
n
c
c
B
"}
(47,1,1) = {"
t
r
i
D
x
u
y
L
H
a
O
O
f
f
k
k
J
J
h
h
n
n
c
c
B
"}
(48,1,1) = {"
t
r
i
D
x
u
y
L
H
a
O
O
f
f
k
k
J
J
h
h
n
n
c
c
B
"}
(49,1,1) = {"
t
r
i
D
x
u
y
L
H
a
O
O
f
f
k
k
J
J
h
h
n
n
c
c
B
"}
(50,1,1) = {"
t
r
i
D
x
u
y
L
H
a
O
O
f
f
k
k
J
J
h
h
n
n
c
c
B
"}
(51,1,1) = {"
t
r
i
D
x
u
y
L
H
a
O
O
f
f
k
k
J
J
h
h
n
n
c
c
B
"}
(52,1,1) = {"
t
r
i
D
x
u
y
L
H
a
O
O
f
f
k
k
J
J
h
h
n
n
c
c
B
"}
(53,1,1) = {"
t
r
i
D
x
u
y
L
H
a
O
O
f
f
k
k
J
J
h
h
n
n
c
c
B
"}
(54,1,1) = {"
t
r
i
D
x
u
y
L
H
a
O
O
f
f
k
k
J
J
h
h
n
n
c
c
B
"}
(55,1,1) = {"
t
r
i
D
x
u
y
L
H
a
O
O
f
f
k
k
J
J
h
h
n
n
c
c
B
"}
(56,1,1) = {"
t
r
i
D
x
u
y
L
H
a
O
O
f
f
k
k
J
J
h
h
n
n
c
c
B
"}
(57,1,1) = {"
t
r
i
D
x
u
y
L
H
a
O
O
f
f
k
k
J
J
h
h
n
n
c
c
B
"}
(58,1,1) = {"
t
r
i
D
x
u
y
L
H
a
O
O
f
f
k
k
J
J
h
h
n
n
c
c
B
"}
(59,1,1) = {"
t
r
i
D
x
u
y
L
H
a
O
O
f
f
k
k
J
J
h
h
n
n
c
c
B
"}
(60,1,1) = {"
t
r
i
D
x
u
y
L
H
a
O
O
f
f
k
k
J
J
h
h
n
n
c
c
B
"}
(61,1,1) = {"
t
r
i
D
x
u
y
L
H
a
O
O
f
f
k
k
J
J
h
h
n
n
c
c
B
"}
(62,1,1) = {"
t
r
i
D
x
u
y
L
H
a
O
O
f
f
k
k
J
J
h
h
n
n
c
c
B
"}
(63,1,1) = {"
t
r
i
D
x
u
y
L
H
a
O
O
f
f
k
k
J
J
h
h
n
n
c
c
B
"}
(64,1,1) = {"
t
r
i
D
x
u
y
L
H
a
O
O
f
f
k
k
J
J
h
h
n
n
c
c
B
"}
(65,1,1) = {"
t
r
i
D
x
u
y
L
H
a
O
O
f
f
k
k
J
J
h
h
n
n
c
c
B
"}
(66,1,1) = {"
t
r
i
D
x
u
y
L
H
a
O
O
f
f
k
k
J
J
h
h
n
n
c
c
B
"}
(67,1,1) = {"
t
r
i
D
x
u
y
L
H
a
O
O
f
f
k
k
J
J
h
h
n
n
c
c
B
"}
(68,1,1) = {"
t
r
i
D
x
u
y
L
H
a
O
O
f
f
k
k
J
J
h
h
n
n
c
c
B
"}
(69,1,1) = {"
t
r
i
D
x
u
y
L
H
a
O
O
f
f
k
k
J
J
h
h
n
n
c
c
B
"}
(70,1,1) = {"
t
r
i
D
x
u
y
L
H
a
O
O
f
f
k
k
J
J
h
h
n
n
c
c
B
"}
(71,1,1) = {"
t
r
i
D
x
u
y
L
H
a
O
O
f
f
k
k
J
J
h
h
n
n
c
c
B
"}
(72,1,1) = {"
t
r
i
D
x
u
y
L
H
a
O
O
f
f
k
k
J
J
h
h
n
n
c
c
B
"}
(73,1,1) = {"
t
r
i
D
x
u
y
L
H
a
O
O
f
f
k
k
J
J
h
h
n
n
c
c
B
"}
(74,1,1) = {"
t
r
i
D
x
u
y
L
H
a
O
O
f
f
k
k
J
J
h
h
n
n
c
c
B
"}
(75,1,1) = {"
t
r
i
D
x
u
y
L
H
a
O
O
f
f
k
k
J
J
h
h
n
n
c
c
B
"}
(76,1,1) = {"
t
r
i
D
x
u
y
L
H
a
O
O
f
f
k
k
J
J
h
h
n
n
c
c
B
"}
(77,1,1) = {"
t
r
i
D
x
u
y
L
H
a
O
O
f
f
k
k
J
J
h
h
n
n
c
c
B
"}
(78,1,1) = {"
t
r
i
D
x
u
y
L
H
a
O
O
f
f
k
k
J
J
h
h
n
n
c
c
B
"}
(79,1,1) = {"
t
r
i
D
x
u
y
L
H
a
O
O
f
f
k
k
J
J
h
h
n
n
c
c
B
"}
(80,1,1) = {"
t
r
i
D
x
u
y
L
H
a
O
O
f
f
k
k
J
J
h
h
n
n
c
c
B
"}
(81,1,1) = {"
t
r
i
D
x
u
y
L
H
a
O
O
f
f
k
k
J
J
h
h
n
n
c
c
B
"}
(82,1,1) = {"
t
r
i
D
x
u
y
L
H
a
O
O
f
f
k
k
J
J
h
h
n
n
c
c
B
"}
(83,1,1) = {"
t
r
i
D
x
u
y
L
H
a
O
O
f
f
k
k
J
J
h
h
n
n
c
c
B
"}
(84,1,1) = {"
t
r
i
D
x
u
y
L
H
a
O
O
f
f
k
k
J
J
h
h
n
n
c
c
B
"}
(85,1,1) = {"
t
r
i
D
x
u
y
L
H
a
O
O
f
f
k
k
J
J
h
h
n
n
c
c
B
"}
(86,1,1) = {"
t
r
i
D
x
u
y
L
H
a
O
O
f
f
k
k
J
J
h
h
n
n
c
c
B
"}
(87,1,1) = {"
t
r
i
D
x
u
y
L
H
a
O
O
f
f
k
k
J
J
h
h
n
n
c
c
B
"}
(88,1,1) = {"
t
r
i
D
x
u
y
L
H
a
O
O
f
f
k
k
J
J
h
h
n
n
c
c
B
"}
(89,1,1) = {"
t
r
i
D
x
u
y
L
H
a
O
O
f
f
k
k
J
J
h
h
n
n
c
c
B
"}
(90,1,1) = {"
t
r
i
D
x
u
y
L
H
a
O
O
f
f
k
k
J
J
h
h
n
n
c
c
B
"}
(91,1,1) = {"
t
r
i
D
x
u
y
L
H
a
O
O
f
f
k
k
J
J
h
h
n
n
c
c
B
"}
(92,1,1) = {"
t
r
i
D
x
u
y
L
H
a
O
O
f
f
k
k
J
J
h
h
n
n
c
c
B
"}
(93,1,1) = {"
t
r
i
D
x
u
y
L
H
a
O
O
f
f
k
k
J
J
h
h
n
n
c
c
B
"}
(94,1,1) = {"
t
r
i
D
x
u
y
L
H
a
O
O
f
f
k
k
J
J
h
h
n
n
c
c
B
"}
(95,1,1) = {"
t
r
i
D
x
u
y
L
H
a
O
O
f
f
k
k
J
J
h
h
n
n
c
c
B
"}
(96,1,1) = {"
t
r
i
D
x
u
y
L
H
a
O
O
f
f
k
k
J
J
h
h
n
n
c
c
B
"}
(97,1,1) = {"
t
r
i
D
x
u
y
L
H
a
O
O
f
f
k
k
J
J
h
h
n
n
c
c
B
"}
(98,1,1) = {"
t
r
i
D
x
u
y
L
H
a
O
O
f
f
k
k
J
J
h
h
n
n
c
c
B
"}
(99,1,1) = {"
t
r
i
D
x
u
y
L
H
a
O
O
f
f
k
k
J
J
h
h
n
n
c
c
B
"}
(100,1,1) = {"
t
r
i
D
x
u
y
L
H
a
O
O
f
f
k
k
J
J
h
h
n
n
c
c
B
"}
(101,1,1) = {"
t
r
i
D
x
u
y
L
H
a
O
O
f
f
k
k
J
J
h
h
n
n
c
c
B
"}
(102,1,1) = {"
t
r
i
D
x
u
y
L
H
a
O
O
f
f
k
k
J
J
h
h
n
n
c
c
B
"}
(103,1,1) = {"
t
r
i
D
x
u
y
L
H
a
O
O
f
f
k
k
J
J
h
h
n
n
c
c
B
"}
(104,1,1) = {"
t
r
i
D
x
u
y
L
H
a
O
O
f
f
k
k
J
J
h
h
n
n
c
c
B
"}
(105,1,1) = {"
t
r
i
D
x
u
y
L
H
a
O
O
f
f
k
k
J
J
h
h
n
n
c
c
B
"}
(106,1,1) = {"
t
r
i
D
x
u
y
L
H
a
O
O
f
f
k
k
J
J
h
h
n
n
c
c
B
"}
(107,1,1) = {"
t
r
i
D
x
u
y
L
H
a
O
O
f
f
k
k
J
J
h
h
n
n
c
c
B
"}
(108,1,1) = {"
t
r
i
D
x
u
y
L
H
a
O
O
f
f
k
k
J
J
h
h
n
n
c
c
B
"}
(109,1,1) = {"
t
r
i
D
x
u
y
L
H
a
O
O
f
f
k
k
J
J
h
h
n
n
c
c
B
"}
(110,1,1) = {"
t
r
i
D
x
u
y
L
H
a
O
O
f
f
k
k
J
J
h
h
n
n
c
c
B
"}
(111,1,1) = {"
t
r
i
D
x
u
y
L
H
a
O
O
f
f
k
k
J
J
h
h
n
n
c
c
B
"}
(112,1,1) = {"
t
r
i
D
x
u
y
L
H
a
O
O
f
f
k
k
J
J
h
h
n
n
c
c
B
"}
(113,1,1) = {"
t
r
i
D
x
u
y
L
H
a
O
O
f
f
k
k
J
J
h
h
n
n
c
c
B
"}
(114,1,1) = {"
t
r
i
D
x
u
y
L
H
a
O
O
f
f
k
k
J
J
h
h
n
n
c
c
B
"}
(115,1,1) = {"
t
r
i
D
x
u
y
L
H
a
O
O
f
f
k
k
J
J
h
h
n
n
c
c
B
"}
(116,1,1) = {"
t
r
i
D
x
u
y
L
H
a
O
O
f
f
k
k
J
J
h
h
n
n
c
c
B
"}
(117,1,1) = {"
t
r
i
D
x
u
y
L
H
a
O
O
f
f
k
k
J
J
h
h
n
n
c
c
B
"}
(118,1,1) = {"
t
r
i
D
x
u
y
L
H
a
O
O
f
f
k
k
J
J
h
h
n
n
c
c
B
"}
(119,1,1) = {"
t
r
i
D
x
u
y
L
H
a
O
O
f
f
k
k
J
J
h
h
n
n
c
c
B
"}
(120,1,1) = {"
t
r
i
D
x
u
y
L
H
a
O
O
f
f
k
k
J
J
h
h
n
n
c
c
B
"}
(121,1,1) = {"
t
r
i
D
x
u
y
L
H
a
O
O
f
f
k
k
J
J
h
h
n
n
c
c
B
"}
(122,1,1) = {"
t
r
i
D
x
u
y
L
H
a
O
O
f
f
k
k
J
J
h
h
n
n
c
c
B
"}
(123,1,1) = {"
t
r
i
D
x
u
y
L
H
a
O
O
f
f
k
k
J
J
h
h
n
n
c
c
B
"}
(124,1,1) = {"
t
r
i
D
x
u
y
L
H
a
O
O
f
f
k
k
J
J
h
h
n
n
c
c
B
"}
(125,1,1) = {"
t
r
i
D
x
u
y
L
H
a
O
O
f
f
k
k
J
J
h
h
n
n
c
c
B
"}
(126,1,1) = {"
t
r
i
D
x
u
y
L
H
a
O
O
f
f
k
k
J
J
h
h
n
n
c
c
B
"}
(127,1,1) = {"
t
r
i
D
x
u
y
L
H
a
O
O
f
f
k
k
J
J
h
h
n
n
c
c
B
"}
(128,1,1) = {"
t
r
i
D
x
u
y
L
H
a
O
O
f
f
k
k
J
J
h
h
n
n
c
c
B
"}
(129,1,1) = {"
t
r
i
D
x
u
y
L
H
a
O
O
f
f
k
k
J
J
h
h
n
n
c
c
B
"}
(130,1,1) = {"
t
r
i
D
x
u
y
L
H
a
O
O
f
f
k
k
J
J
h
h
n
n
c
c
B
"}
(131,1,1) = {"
t
r
i
D
x
u
y
L
H
a
O
O
f
f
k
k
J
J
h
h
n
n
c
c
B
"}
(132,1,1) = {"
t
r
i
D
x
u
y
L
H
a
O
O
f
f
k
k
J
J
h
h
n
n
c
c
B
"}
(133,1,1) = {"
t
r
i
D
x
u
y
L
H
a
O
O
f
f
k
k
J
J
h
h
n
n
c
c
B
"}
(134,1,1) = {"
t
r
i
D
x
u
y
L
H
a
O
O
f
f
k
k
J
J
h
h
n
n
c
c
B
"}
(135,1,1) = {"
t
r
i
D
x
u
y
L
H
a
O
O
f
f
k
k
J
J
h
h
n
n
c
c
B
"}
(136,1,1) = {"
t
r
i
D
x
u
y
L
H
a
O
O
f
f
k
k
J
J
h
h
n
n
c
c
B
"}
(137,1,1) = {"
t
r
i
D
x
u
y
L
H
a
O
O
f
f
k
k
J
J
h
h
n
n
c
c
B
"}
(138,1,1) = {"
t
r
i
D
x
u
y
L
H
a
O
O
f
f
k
k
J
J
h
h
n
n
c
c
B
"}
(139,1,1) = {"
t
r
i
D
x
u
y
L
H
a
O
O
f
f
k
k
J
J
h
h
n
n
c
c
B
"}
(140,1,1) = {"
t
r
i
D
x
u
y
L
H
a
O
O
f
f
k
k
J
J
h
h
n
n
c
c
B
"}
(141,1,1) = {"
t
r
i
D
x
u
y
L
H
a
O
O
f
f
k
k
J
J
h
h
n
n
c
c
B
"}
(142,1,1) = {"
t
r
i
D
x
u
y
L
H
a
O
O
f
f
k
k
J
J
h
h
n
n
c
c
B
"}
(143,1,1) = {"
t
r
i
D
x
u
y
L
H
a
O
O
f
f
k
k
J
J
h
h
n
n
c
c
B
"}
(144,1,1) = {"
t
r
i
D
x
u
y
L
H
a
O
O
f
f
k
k
J
J
h
h
n
n
c
c
B
"}
(145,1,1) = {"
t
r
i
D
x
u
y
L
H
a
O
O
f
f
k
k
J
J
h
h
n
n
c
c
B
"}
(146,1,1) = {"
t
r
i
D
x
u
y
L
H
a
O
O
f
f
k
k
J
J
h
h
n
n
c
c
B
"}
(147,1,1) = {"
t
r
i
D
x
u
y
L
H
a
O
O
f
f
k
k
J
J
h
h
n
n
c
c
B
"}
(148,1,1) = {"
t
r
i
D
x
u
y
L
H
a
O
O
f
f
k
k
J
J
h
h
n
n
c
c
B
"}
(149,1,1) = {"
t
r
i
D
x
u
y
L
H
a
O
O
f
f
k
k
J
J
h
h
n
n
c
c
B
"}
(150,1,1) = {"
t
r
i
D
x
u
y
L
H
a
O
O
f
f
k
k
J
J
h
h
n
n
c
c
B
"}
(151,1,1) = {"
t
r
i
D
x
u
y
L
H
a
O
O
f
f
k
k
J
J
h
h
n
n
c
c
B
"}
(152,1,1) = {"
t
r
i
D
x
u
y
L
H
a
O
O
f
f
k
k
J
J
h
h
n
n
c
c
B
"}
(153,1,1) = {"
t
r
i
D
x
u
y
L
H
a
O
O
f
f
k
k
J
J
h
h
n
n
c
c
B
"}
(154,1,1) = {"
t
r
i
D
x
u
y
L
H
a
O
O
f
f
k
k
J
J
h
h
n
n
c
c
B
"}
(155,1,1) = {"
t
r
i
D
x
u
y
L
H
a
O
O
f
f
k
k
J
J
h
h
n
n
c
c
B
"}
(156,1,1) = {"
t
r
i
D
x
u
y
L
H
a
O
O
f
f
k
k
J
J
h
h
n
n
c
c
B
"}
(157,1,1) = {"
t
r
i
D
x
u
y
L
H
a
O
O
f
f
k
k
J
J
h
h
n
n
c
c
B
"}
(158,1,1) = {"
t
r
i
D
x
u
y
L
H
a
O
O
f
f
k
k
J
J
h
h
n
n
c
c
B
"}
(159,1,1) = {"
t
r
i
D
x
u
y
L
H
a
O
O
f
f
k
k
J
J
h
h
n
n
c
c
B
"}
(160,1,1) = {"
t
r
i
D
x
u
y
L
H
a
O
O
f
f
k
k
J
J
h
h
n
n
c
c
B
"}
(161,1,1) = {"
t
r
i
D
x
u
y
L
H
a
O
O
f
f
k
k
J
J
h
h
n
n
c
c
B
"}
(162,1,1) = {"
t
r
i
D
x
u
y
L
H
a
O
O
f
f
k
k
J
J
h
h
n
n
c
c
B
"}
(163,1,1) = {"
t
r
i
D
x
u
y
L
H
a
O
O
f
f
k
k
J
J
h
h
n
n
c
c
B
"}
(164,1,1) = {"
t
r
i
D
x
u
y
L
H
a
O
O
f
f
k
k
J
J
h
h
n
n
c
c
B
"}
(165,1,1) = {"
t
r
i
D
x
u
y
L
H
a
O
O
f
f
k
k
J
J
h
h
n
n
c
c
B
"}
(166,1,1) = {"
t
r
i
D
x
u
y
L
H
a
O
O
f
f
k
k
J
J
h
h
n
n
c
c
B
"}
(167,1,1) = {"
t
r
i
D
x
u
y
L
H
a
O
O
f
f
k
k
J
J
h
h
n
n
c
c
B
"}
(168,1,1) = {"
t
r
i
D
x
u
y
L
H
a
O
O
f
f
k
k
J
J
h
h
n
n
c
c
B
"}
(169,1,1) = {"
t
r
i
D
x
u
y
L
H
a
O
O
f
f
k
k
J
J
h
h
n
n
c
c
B
"}
(170,1,1) = {"
t
r
i
D
x
u
y
L
H
a
O
O
f
f
k
k
J
J
h
h
n
n
c
c
B
"}
(171,1,1) = {"
t
r
i
D
x
u
y
L
H
a
O
O
f
f
k
k
J
J
h
h
n
n
c
c
B
"}
(172,1,1) = {"
t
r
i
D
x
u
y
L
H
a
O
O
f
f
k
k
J
J
h
h
n
n
c
c
B
"}
(173,1,1) = {"
t
r
i
D
x
u
y
L
H
a
O
O
f
f
k
k
J
J
h
h
n
n
c
c
B
"}
(174,1,1) = {"
t
r
i
D
x
u
y
L
H
a
O
O
f
f
k
k
J
J
h
h
n
n
c
c
B
"}
(175,1,1) = {"
t
r
i
D
x
u
y
L
H
a
O
O
f
f
k
k
J
J
h
h
n
n
c
c
B
"}
(176,1,1) = {"
t
r
i
D
x
u
y
L
H
a
O
O
f
f
k
k
J
J
h
h
n
n
c
c
B
"}
(177,1,1) = {"
t
r
i
D
x
u
y
L
H
a
O
O
f
f
k
k
J
J
h
h
n
n
c
c
B
"}
(178,1,1) = {"
t
r
i
D
x
u
y
L
H
a
O
O
f
f
k
k
J
J
h
h
n
n
c
c
B
"}
(179,1,1) = {"
t
r
i
D
x
u
y
L
H
a
O
O
f
f
k
k
J
J
h
h
n
n
c
c
B
"}
(180,1,1) = {"
t
r
i
D
x
u
y
L
H
a
O
O
f
f
k
k
J
J
h
h
n
n
c
c
B
"}
(181,1,1) = {"
t
r
i
D
x
u
y
L
H
a
O
O
f
f
k
k
J
J
h
h
n
n
c
c
B
"}
(182,1,1) = {"
t
r
i
D
x
u
y
L
H
a
O
O
f
f
k
k
J
J
h
h
n
n
c
c
B
"}
(183,1,1) = {"
t
r
i
D
x
u
y
L
H
a
O
O
f
f
k
k
J
J
h
h
n
n
c
c
B
"}
(184,1,1) = {"
t
r
i
D
x
u
y
L
H
a
O
O
f
f
k
k
J
J
h
h
n
n
c
c
B
"}
(185,1,1) = {"
t
r
i
D
x
u
y
L
H
a
O
O
f
f
k
k
J
J
h
h
n
n
c
c
B
"}
(186,1,1) = {"
t
r
i
D
x
u
y
L
H
a
O
O
f
f
k
k
J
J
h
h
n
n
c
c
B
"}
(187,1,1) = {"
t
r
i
D
x
u
y
L
H
a
O
O
f
f
k
k
J
J
h
h
n
n
c
c
B
"}
(188,1,1) = {"
t
r
i
D
x
u
y
L
H
a
O
O
f
f
k
k
J
J
h
h
n
n
c
c
B
"}
(189,1,1) = {"
t
r
i
D
x
u
y
L
H
a
O
O
f
f
k
k
J
J
h
h
n
n
c
c
B
"}
(190,1,1) = {"
t
r
i
D
x
u
y
L
H
a
O
O
f
f
k
k
J
J
h
h
n
n
c
c
B
"}
(191,1,1) = {"
t
r
i
D
x
u
y
L
H
a
O
O
f
f
k
k
J
J
h
h
n
n
c
c
B
"}
(192,1,1) = {"
t
r
i
D
x
u
y
L
H
a
O
O
f
f
k
k
J
J
h
h
n
n
c
c
B
"}
(193,1,1) = {"
t
r
i
D
x
u
y
L
H
a
O
O
f
f
k
k
J
J
h
h
n
n
c
c
B
"}
(194,1,1) = {"
t
r
i
D
x
u
y
L
H
a
O
O
f
f
k
k
J
J
h
h
n
n
c
c
B
"}
(195,1,1) = {"
t
r
i
D
x
u
y
L
H
a
O
O
f
f
k
k
J
J
h
h
n
n
c
c
B
"}
(196,1,1) = {"
t
r
i
D
x
u
y
L
H
a
O
O
f
f
k
k
J
J
h
h
n
n
c
c
B
"}
(197,1,1) = {"
t
r
i
D
x
u
y
L
H
a
O
O
f
f
k
k
J
J
h
h
n
n
c
c
B
"}
(198,1,1) = {"
t
r
i
D
x
u
y
L
H
a
O
O
f
f
k
k
J
J
h
h
n
n
c
c
B
"}
(199,1,1) = {"
t
r
i
D
x
u
y
L
H
a
O
O
f
f
k
k
J
J
h
h
n
n
c
c
B
"}
(200,1,1) = {"
t
r
i
D
x
u
y
L
H
a
O
O
f
f
k
k
J
J
h
h
n
n
c
c
B
"}
(201,1,1) = {"
t
r
i
D
x
u
y
L
H
a
O
O
f
f
k
k
J
J
h
h
n
n
c
c
B
"}
(202,1,1) = {"
t
r
i
D
x
u
y
L
H
a
O
O
f
f
k
k
J
J
h
h
n
n
c
c
B
"}
(203,1,1) = {"
t
r
i
D
x
u
y
L
H
a
O
O
f
f
k
k
J
J
h
h
n
n
c
c
B
"}
(204,1,1) = {"
t
r
i
D
x
u
y
L
H
a
O
O
f
f
k
k
J
J
h
h
n
n
c
c
B
"}
(205,1,1) = {"
t
r
i
D
x
u
y
L
H
a
O
O
f
f
k
k
J
J
h
h
n
n
c
c
B
"}
(206,1,1) = {"
t
r
i
D
x
u
y
L
H
a
O
O
f
f
k
k
J
J
h
h
n
n
c
c
B
"}
(207,1,1) = {"
t
r
i
D
x
u
y
L
H
a
O
O
f
f
k
k
J
J
h
h
n
n
c
c
B
"}
(208,1,1) = {"
t
r
i
D
x
u
y
L
H
a
O
O
f
f
k
k
J
J
h
h
n
n
c
c
B
"}
(209,1,1) = {"
t
r
i
D
x
u
y
L
H
a
O
O
f
f
k
k
J
J
h
h
n
n
c
c
B
"}
(210,1,1) = {"
t
r
i
D
x
u
y
L
H
a
O
O
f
f
k
k
J
J
h
h
n
n
c
c
B
"}
(211,1,1) = {"
t
r
i
D
x
u
y
L
H
a
O
O
f
f
k
k
J
J
h
h
n
n
c
c
B
"}
(212,1,1) = {"
t
r
i
D
x
u
y
L
H
a
O
O
f
f
k
k
J
J
h
h
n
n
c
c
B
"}
(213,1,1) = {"
t
r
i
D
x
u
y
L
H
a
O
O
f
f
k
k
J
J
h
h
n
n
c
c
B
"}
(214,1,1) = {"
t
r
i
D
x
u
y
L
H
a
O
O
f
f
k
k
J
J
h
h
n
n
c
c
B
"}
(215,1,1) = {"
t
r
i
D
x
u
y
L
H
a
O
O
f
f
k
k
J
J
h
h
n
n
c
c
B
"}
(216,1,1) = {"
t
r
i
D
x
u
y
L
H
a
O
O
f
f
k
k
J
J
h
h
n
n
c
c
B
"}
(217,1,1) = {"
t
r
i
D
x
u
y
L
H
a
O
O
f
f
k
k
J
J
h
h
n
n
c
c
B
"}
(218,1,1) = {"
t
r
i
D
x
u
y
L
H
a
O
O
f
f
k
k
J
J
h
h
n
n
c
c
B
"}
(219,1,1) = {"
t
r
i
D
x
u
y
L
H
a
O
O
f
f
k
k
J
J
h
h
n
n
c
c
B
"}
(220,1,1) = {"
t
r
i
D
x
u
y
L
H
a
O
O
f
f
k
k
J
J
h
h
n
n
c
c
B
"}
(221,1,1) = {"
t
r
i
D
x
u
y
L
H
a
O
O
f
f
k
k
J
J
h
h
n
n
c
c
B
"}
(222,1,1) = {"
t
r
i
D
x
u
y
L
H
a
O
O
f
f
k
k
J
J
h
h
n
n
c
c
B
"}
(223,1,1) = {"
t
r
i
D
x
u
y
L
H
a
O
O
f
f
k
k
J
J
h
h
n
n
c
c
B
"}
(224,1,1) = {"
t
r
i
D
x
u
y
L
H
a
O
O
f
f
k
k
J
J
h
h
n
n
c
c
B
"}
(225,1,1) = {"
t
r
i
D
x
u
y
L
H
a
O
O
f
f
k
k
J
J
h
h
n
n
c
c
B
"}
(226,1,1) = {"
t
r
i
D
x
u
y
L
H
a
O
O
f
f
k
k
J
J
h
h
n
n
c
c
B
"}
(227,1,1) = {"
t
r
i
D
x
u
y
L
H
a
O
O
f
f
k
k
J
J
h
h
n
n
c
c
B
"}
(228,1,1) = {"
t
r
i
D
x
u
y
L
H
a
O
O
f
f
k
k
J
J
h
h
n
n
c
c
B
"}
(229,1,1) = {"
t
r
i
D
x
u
y
L
H
a
O
O
f
f
k
k
J
J
h
h
n
n
c
c
B
"}
(230,1,1) = {"
t
r
i
D
x
u
y
L
H
a
O
O
f
f
k
k
J
J
h
h
n
n
c
c
B
"}
(231,1,1) = {"
t
r
i
D
x
u
y
L
H
a
O
O
f
f
k
k
J
J
h
h
n
n
c
c
B
"}
(232,1,1) = {"
t
r
i
D
x
u
y
L
H
a
O
O
f
f
k
k
J
J
h
h
n
n
c
c
B
"}
(233,1,1) = {"
t
r
i
D
x
u
y
L
H
a
O
O
f
f
k
k
J
J
h
h
n
n
c
c
B
"}
(234,1,1) = {"
t
r
i
D
x
u
y
L
H
a
O
O
f
f
k
k
J
J
h
h
n
n
c
c
B
"}
(235,1,1) = {"
t
r
i
D
x
u
y
L
H
a
O
O
f
f
k
k
J
J
h
h
n
n
c
c
B
"}
(236,1,1) = {"
t
r
i
D
x
u
y
L
H
a
O
O
f
f
k
k
J
J
h
h
n
n
c
c
B
"}
(237,1,1) = {"
t
r
i
D
x
u
y
L
H
a
O
O
f
f
k
k
J
J
h
h
n
n
c
c
B
"}
(238,1,1) = {"
t
r
i
D
x
u
y
L
H
a
O
O
f
f
k
k
J
J
h
h
n
n
c
c
B
"}
(239,1,1) = {"
t
r
i
D
x
u
y
L
H
a
O
O
f
f
k
k
J
J
h
h
n
n
c
c
B
"}
(240,1,1) = {"
t
r
i
D
x
u
y
L
H
a
O
O
f
f
k
k
J
J
h
h
n
n
c
c
B
"}
(241,1,1) = {"
t
r
i
D
x
u
y
L
H
a
O
O
f
f
k
k
J
J
h
h
n
n
c
c
B
"}
(242,1,1) = {"
t
r
i
D
x
u
y
L
H
a
O
O
f
f
k
k
J
J
h
h
n
n
c
c
B
"}
(243,1,1) = {"
t
r
i
D
x
u
y
L
H
a
O
O
f
f
k
k
J
J
h
h
n
n
c
c
B
"}
(244,1,1) = {"
t
r
i
D
x
u
y
L
H
a
O
O
f
f
k
k
J
J
h
h
n
n
c
c
B
"}
(245,1,1) = {"
t
r
i
D
x
u
y
L
H
a
O
O
f
f
k
k
J
J
h
h
n
n
c
c
B
"}
(246,1,1) = {"
t
r
i
D
x
u
y
L
H
a
O
O
f
f
k
k
J
J
h
h
n
n
c
c
B
"}
(247,1,1) = {"
t
r
i
D
x
u
y
L
H
a
O
O
f
f
k
k
J
J
h
h
n
n
c
c
B
"}
(248,1,1) = {"
t
r
i
D
x
u
y
L
H
a
O
O
f
f
k
k
J
J
h
h
n
n
c
c
B
"}
(249,1,1) = {"
t
r
i
D
x
u
y
L
H
a
O
O
f
f
k
k
J
J
h
h
n
n
c
c
B
"}
(250,1,1) = {"
t
r
i
D
x
u
y
L
H
a
O
O
f
f
k
k
J
J
h
h
n
n
c
c
B
"}
(251,1,1) = {"
t
r
i
D
x
u
y
L
H
a
O
O
f
f
k
k
J
J
h
h
n
n
c
c
B
"}
(252,1,1) = {"
t
r
i
D
x
u
y
L
H
a
O
O
f
f
k
k
J
J
h
h
n
n
c
c
B
"}
(253,1,1) = {"
t
r
i
D
x
l
V
L
H
G
O
O
f
f
k
k
J
J
h
h
n
n
c
c
B
"}
(254,1,1) = {"
t
s
C
D
Y
u
e
L
X
G
O
O
f
f
k
k
J
J
h
h
n
n
c
c
B
"}
(255,1,1) = {"
t
r
i
w
x
q
y
Z
H
a
O
O
f
f
k
k
J
J
h
h
n
n
c
c
B
"}
