//MAP CONVERTED BY dmm2tgm.py THIS HEADER COMMENT PREVENTS RECONVERSION, DO NOT REMOVE
"a" = (
/obj/structure/fluff/tram_rail/end{
	dir = 8
	},
/turf/open/openspace,
/area/station/hallway/primary/tram/left)
"b" = (
/obj/structure/disposalpipe/segment{
	dir = 4
	},
/obj/machinery/atmospherics/components/unary/vent_scrubber/on/layer2{
	dir = 1
	},
/obj/effect/turf_decal/trimline/tram/filled/line,
/obj/effect/turf_decal/trimline/tram/filled/warning,
/turf/open/floor/iron,
/area/station/hallway/primary/tram/left)
"c" = (
/obj/structure/sign/directions/vault{
	dir = 1;
	pixel_y = 7
	},
/obj/structure/sign/directions/command{
	dir = 1;
	pixel_y = -7
	},
/obj/structure/sign/directions/security{
	dir = 1;
	pixel_y = 14
	},
/obj/structure/sign/directions/supply{
	dir = 4
	},
/obj/effect/spawner/random/vending/colavend{
	pixel_x = 5
	},
/turf/closed/wall,
/area/station/hallway/primary/tram/left)
"d" = (
/turf/open/openspace,
/area/station/hallway/primary/tram/left)
"f" = (
/obj/machinery/static_signal/southwest,
/obj/effect/turf_decal/stripes/white/line{
	dir = 1
	},
/obj/structure/railing{
	dir = 4
	},
/turf/open/floor/iron,
/area/station/hallway/primary/tram/left)
"g" = (
/obj/structure/disposalpipe/sorting/mail/flip{
	dir = 4
	},
/obj/effect/mapping_helpers/mail_sorting/service/hop_office,
/obj/effect/mapping_helpers/mail_sorting/security/hos_office,
/obj/effect/mapping_helpers/mail_sorting/security/detectives_office,
/obj/effect/mapping_helpers/mail_sorting/security/general,
/obj/effect/turf_decal/trimline/tram/filled/corner,
/obj/effect/turf_decal/trimline/tram/corner,
/turf/open/floor/iron,
/area/station/hallway/primary/tram/left)
"i" = (
/obj/structure/disposalpipe/segment{
	dir = 4
	},
/obj/effect/turf_decal/trimline/tram/filled/line,
/obj/effect/turf_decal/trimline/tram/filled/warning,
/turf/open/floor/iron,
/area/station/hallway/primary/tram/left)
"j" = (
/obj/effect/turf_decal/tile/neutral/tram,
/obj/effect/landmark/transport/nav_beacon/tram/platform/tramstation/west,
/turf/open/indestructible/tram/plate,
/area/station/hallway/primary/tram/left)
"k" = (
/obj/structure/fluff/tram_rail/electric{
	dir = 1
	},
/turf/open/openspace,
/area/station/hallway/primary/tram/left)
"l" = (
/obj/structure/fluff/tram_rail/electric/anchor,
/turf/open/openspace,
/area/station/hallway/primary/tram/left)
"m" = (
/obj/structure/fluff/tram_rail/electric/anchor{
	dir = 1
	},
/turf/open/openspace,
/area/station/hallway/primary/tram/left)
"o" = (
/obj/structure/fluff/tram_rail/floor{
	dir = 1
	},
/turf/open/floor/glass/reinforced/tram,
/area/station/hallway/primary/tram/left)
"p" = (
/obj/machinery/camera/directional/east{
	pixel_y = -23;
	c_tag = "Hallway - Port Tram Platform South"
	},
/obj/machinery/light/directional/east,
/turf/open/floor/noslip/tram,
/area/station/hallway/primary/tram/left)
"q" = (
/obj/structure/disposalpipe/segment{
	dir = 4
	},
/obj/machinery/atmospherics/components/unary/vent_pump/on/layer4{
	dir = 1
	},
/obj/effect/turf_decal/trimline/tram/filled/line,
/obj/effect/turf_decal/trimline/tram/filled/warning,
/turf/open/floor/iron,
/area/station/hallway/primary/tram/left)
"x" = (
/obj/machinery/static_signal/northwest,
/obj/effect/turf_decal/stripes/white/line,
/obj/structure/railing{
	dir = 4
	},
/turf/open/floor/iron,
/area/station/hallway/primary/tram/left)
"y" = (
/obj/machinery/light/directional/east,
/turf/open/openspace,
/area/station/hallway/primary/tram/left)
"A" = (
/obj/effect/turf_decal/caution/stand_clear/white{
	dir = 8
	},
/obj/effect/turf_decal/stripes/white/line{
	dir = 4
	},
/turf/open/indestructible/tram,
/area/station/hallway/primary/tram/left)
"B" = (
/obj/machinery/light/directional/west,
/turf/open/openspace,
/area/station/hallway/primary/tram/left)
"C" = (
/turf/open/floor/glass/reinforced/tram,
/area/station/hallway/primary/tram/left)
"D" = (
/obj/machinery/light/directional/west,
/turf/open/floor/noslip/tram,
/area/station/hallway/primary/tram/left)
"E" = (
/obj/structure/fluff/tram_rail/electric,
/turf/open/openspace,
/area/station/hallway/primary/tram/left)
"F" = (
/obj/structure/sign/directions/vault{
	dir = 1;
	pixel_y = 7
	},
/obj/structure/sign/directions/command{
	dir = 1;
	pixel_y = -7
	},
/obj/structure/sign/directions/security{
	dir = 1;
	pixel_y = 14
	},
/obj/structure/sign/directions/supply{
	dir = 4
	},
/turf/closed/wall,
/area/station/hallway/primary/tram/left)
"G" = (
/obj/structure/sign/directions/upload{
	dir = 4;
	pixel_y = 7
	},
/obj/structure/sign/directions/engineering{
	dir = 4;
	pixel_y = 14
	},
/obj/structure/sign/directions/medical{
	dir = 4;
	pixel_y = -7
	},
/obj/structure/sign/directions/evac{
	dir = 4
	},
/turf/closed/wall,
/area/station/hallway/primary/tram/left)
"H" = (
/obj/structure/fluff/tram_rail/end{
	dir = 4
	},
/turf/open/openspace,
/area/station/hallway/primary/tram/left)
"I" = (
/obj/structure/disposalpipe/segment{
	dir = 4
	},
/obj/effect/turf_decal/trimline/tram/filled/corner{
	dir = 8
	},
/obj/effect/turf_decal/trimline/tram/corner{
	dir = 8
	},
/turf/open/floor/iron,
/area/station/hallway/primary/tram/left)
"J" = (
/obj/machinery/camera/directional/west{
	c_tag = "Hallway - Port Tram Platform North"
	},
/obj/machinery/light/directional/west,
/turf/open/floor/noslip/tram,
/area/station/hallway/primary/tram/left)
"K" = (
/obj/machinery/holopad,
/obj/structure/disposalpipe/segment{
	dir = 4
	},
/obj/effect/turf_decal/trimline/tram/filled/line,
/obj/effect/turf_decal/trimline/tram/filled/warning,
/obj/machinery/button/transport/tram/directional/south{
	id = 1
	},
/obj/machinery/transport/destination_sign/indicator/directional/south,
/turf/open/floor/iron,
/area/station/hallway/primary/tram/left)
"L" = (
/obj/effect/turf_decal/stripes/white/line{
	dir = 1
	},
/obj/machinery/transport/crossing_signal/southeast,
/obj/structure/railing{
	dir = 8
	},
/turf/open/floor/iron,
/area/station/hallway/primary/tram/left)
"M" = (
/obj/effect/turf_decal/stripes/white/line,
/obj/machinery/transport/crossing_signal/northeast,
/obj/structure/railing{
	dir = 8
	},
/turf/open/floor/iron,
/area/station/hallway/primary/tram/left)
"N" = (
/obj/machinery/light/directional/east,
/turf/open/floor/noslip/tram,
/area/station/hallway/primary/tram/left)
"O" = (
/turf/closed/wall,
/area/station/hallway/primary/tram/left)
"P" = (
/obj/effect/landmark/start/hangover,
/obj/structure/disposalpipe/segment{
	dir = 4
	},
/obj/effect/turf_decal/trimline/tram/filled/line,
/obj/effect/turf_decal/trimline/tram/filled/warning,
/turf/open/floor/iron,
/area/station/hallway/primary/tram/left)
"R" = (
/obj/effect/turf_decal/tile/neutral/tram,
/turf/open/indestructible/tram/plate,
/area/station/hallway/primary/tram/left)
"S" = (
/obj/structure/fluff/tram_rail/floor,
/turf/open/floor/glass/reinforced/tram,
/area/station/hallway/primary/tram/left)
"T" = (
/turf/open/floor/noslip/tram,
/area/station/hallway/primary/tram/left)
"X" = (
/obj/structure/sign/directions/upload{
	dir = 4;
	pixel_y = -7
	},
/obj/structure/sign/directions/engineering{
	dir = 4;
	pixel_y = 7
	},
/obj/structure/sign/directions/medical{
	dir = 4;
	pixel_y = 14
	},
/obj/structure/sign/directions/evac{
	dir = 4
	},
/turf/closed/wall,
/area/station/hallway/primary/tram/left)
"Y" = (
/obj/effect/turf_decal/stripes/white/line{
	dir = 1
	},
/obj/effect/turf_decal/stripes/white/line,
/obj/effect/turf_decal/tile/neutral/tram,
/turf/open/floor/tram/plate/energized{
	inbound = 1;
	outbound = 2
	},
/area/station/hallway/primary/tram/left)
"Z" = (
/obj/structure/disposalpipe/segment{
	dir = 4
	},
/turf/open/floor/iron,
/area/station/hallway/primary/tram/left)

(1,1,1) = {"
Z
x
C
C
C
C
C
f
"}
(2,1,1) = {"
g
y
d
a
A
H
d
y
"}
(3,1,1) = {"
b
F
d
E
R
k
d
c
"}
(4,1,1) = {"
i
J
d
E
R
k
d
D
"}
(5,1,1) = {"
i
T
d
E
R
k
d
T
"}
(6,1,1) = {"
P
T
d
E
R
k
d
T
"}
(7,1,1) = {"
i
T
d
E
R
k
d
T
"}
(8,1,1) = {"
K
O
d
l
j
m
d
O
"}
(9,1,1) = {"
i
T
d
E
R
k
d
T
"}
(10,1,1) = {"
i
T
d
E
R
k
d
T
"}
(11,1,1) = {"
i
T
d
E
R
k
d
T
"}
(12,1,1) = {"
i
N
d
E
R
k
d
p
"}
(13,1,1) = {"
q
G
d
E
R
k
d
X
"}
(14,1,1) = {"
I
B
d
E
R
k
d
B
"}
(15,1,1) = {"
Z
M
C
S
Y
o
C
L
"}
