//MAP CONVERTED BY dmm2tgm.py THIS HEADER COMMENT PREVENTS RECONVERSION, DO NOT REMOVE
"a" = (
/obj/effect/turf_decal/trimline/neutral/filled/line,
/obj/effect/decal/cleanable/dirt,
/obj/effect/turf_decal/siding/thinplating{
	dir = 1
	},
/obj/machinery/atmospherics/pipe/smart/manifold4w/supply/hidden/layer4,
/obj/machinery/atmospherics/pipe/smart/manifold4w/scrubbers/hidden/layer2,
/obj/effect/turf_decal/trimline/white/warning{
	dir = 1
	},
/obj/machinery/light/small/dim/directional/south,
/turf/open/floor/iron,
/area/station/maintenance/tram/left)
"b" = (
/obj/effect/decal/cleanable/dirt,
/obj/effect/turf_decal/stripes/white/line{
	dir = 1
	},
/obj/effect/turf_decal/stripes/white/line,
/turf/open/floor/iron/white,
/area/station/maintenance/tram/left)
"c" = (
/obj/effect/decal/cleanable/dirt,
/obj/machinery/atmospherics/pipe/smart/manifold4w/supply/hidden/layer4,
/obj/machinery/atmospherics/pipe/smart/manifold4w/scrubbers/hidden/layer2,
/obj/structure/stairs/north,
/turf/open/floor/iron,
/area/station/maintenance/tram/left)
"d" = (
/obj/effect/turf_decal/trimline/neutral/filled/line{
	dir = 1
	},
/obj/effect/decal/cleanable/dirt,
/obj/effect/turf_decal/stripes/line{
	dir = 1
	},
/obj/effect/turf_decal/siding/thinplating,
/obj/machinery/atmospherics/pipe/smart/manifold4w/supply/hidden/layer4,
/obj/machinery/atmospherics/pipe/smart/manifold4w/scrubbers/hidden/layer2,
/obj/effect/turf_decal/trimline/white/warning,
/turf/open/floor/iron,
/area/station/maintenance/tram/left)
"e" = (
/obj/effect/decal/cleanable/dirt,
/obj/structure/lattice/catwalk,
/turf/open/floor/plating,
/area/station/maintenance/tram/left)
"f" = (
/obj/effect/decal/cleanable/dirt,
/obj/effect/turf_decal/stripes/white/line{
	dir = 1
	},
/obj/effect/turf_decal/stripes/white/line,
/turf/open/floor/plating,
/area/station/maintenance/tram/left)
"h" = (
/obj/effect/turf_decal/trimline/neutral/filled/line,
/obj/effect/decal/cleanable/dirt,
/obj/effect/turf_decal/siding/thinplating{
	dir = 1
	},
/obj/machinery/atmospherics/pipe/smart/manifold4w/supply/hidden/layer4,
/obj/machinery/atmospherics/pipe/smart/manifold4w/scrubbers/hidden/layer2,
/obj/effect/turf_decal/trimline/white/warning{
	dir = 1
	},
/obj/structure/railing{
	dir = 4
	},
/obj/machinery/camera/directional/south{
	c_tag = "Maintenance - West Tram Tunnel 2"
	},
/turf/open/floor/iron,
/area/station/maintenance/tram/left)
"i" = (
/obj/effect/decal/cleanable/dirt,
/obj/structure/lattice/catwalk,
/obj/machinery/atmospherics/pipe/smart/manifold4w/supply/hidden/layer4,
/obj/machinery/atmospherics/pipe/smart/manifold4w/scrubbers/hidden/layer2,
/turf/open/floor/plating,
/area/station/maintenance/tram/left)
"j" = (
/obj/effect/decal/cleanable/dirt,
/obj/effect/spawner/random/trash/graffiti{
	pixel_y = 32;
	spawn_loot_chance = 50
	},
/obj/structure/disposalpipe/segment{
	dir = 4
	},
/obj/machinery/atmospherics/pipe/smart/manifold4w/supply/hidden/layer4,
/obj/machinery/atmospherics/pipe/smart/manifold4w/scrubbers/hidden/layer2,
/obj/structure/cable,
/obj/structure/stairs/north,
/turf/open/floor/iron,
/area/station/maintenance/tram/left)
"l" = (
/obj/effect/decal/cleanable/dirt,
/obj/effect/turf_decal/delivery,
/obj/machinery/door/poddoor/shutters{
	id = "trammaintdock"
	},
/turf/open/floor/plating,
/area/station/maintenance/port/central)
"m" = (
/obj/effect/decal/cleanable/dirt,
/turf/open/floor/plating,
/area/station/maintenance/tram/left)
"o" = (
/obj/effect/turf_decal/trimline/neutral/filled/line,
/obj/effect/decal/cleanable/dirt,
/obj/effect/spawner/random/trash/graffiti{
	pixel_y = -32;
	spawn_loot_chance = 50
	},
/obj/effect/turf_decal/siding/thinplating{
	dir = 1
	},
/obj/structure/cable,
/obj/effect/turf_decal/trimline/white/warning{
	dir = 1
	},
/obj/effect/spawner/random/vending/colavend{
	pixel_x = 5
	},
/obj/structure/railing{
	dir = 8
	},
/turf/open/floor/iron,
/area/station/maintenance/tram/left)
"p" = (
/obj/effect/turf_decal/trimline/neutral/filled/line{
	dir = 1
	},
/obj/effect/decal/cleanable/dirt,
/obj/effect/turf_decal/stripes/line{
	dir = 1
	},
/obj/structure/lattice/catwalk,
/obj/effect/turf_decal/siding/thinplating,
/obj/structure/disposalpipe/segment{
	dir = 10
	},
/obj/machinery/atmospherics/pipe/smart/manifold4w/supply/hidden/layer4,
/obj/machinery/atmospherics/pipe/smart/manifold4w/scrubbers/hidden/layer2,
/obj/structure/cable,
/obj/effect/turf_decal/trimline/white/warning,
/turf/open/floor/iron,
/area/station/maintenance/tram/left)
"r" = (
/obj/effect/turf_decal/trimline/neutral/filled/line{
	dir = 1
	},
/obj/effect/decal/cleanable/dirt,
/obj/effect/turf_decal/stripes/line{
	dir = 1
	},
/obj/effect/turf_decal/siding/thinplating,
/obj/structure/disposalpipe/segment{
	dir = 4
	},
/obj/machinery/atmospherics/pipe/smart/manifold4w/supply/hidden/layer4,
/obj/machinery/atmospherics/pipe/smart/manifold4w/scrubbers/hidden/layer2,
/obj/structure/cable,
/obj/effect/turf_decal/trimline/white/warning,
/turf/open/floor/iron,
/area/station/maintenance/tram/left)
"t" = (
/obj/effect/turf_decal/trimline/neutral/filled/line,
/obj/effect/decal/cleanable/dirt,
/obj/machinery/navbeacon{
	location = "TramLower16";
	codes_txt = "patrol;next_patrol=TramLower1"
	},
/obj/effect/turf_decal/bot{
	dir = 1
	},
/obj/effect/turf_decal/siding/thinplating{
	dir = 1
	},
/obj/machinery/atmospherics/pipe/smart/manifold4w/supply/hidden/layer4,
/obj/machinery/atmospherics/pipe/smart/manifold4w/scrubbers/hidden/layer2,
/obj/effect/turf_decal/trimline/white/warning{
	dir = 1
	},
/obj/structure/railing{
	dir = 8
	},
/turf/open/floor/iron,
/area/station/maintenance/tram/left)
"u" = (
/obj/effect/decal/cleanable/dirt,
/obj/structure/cable,
/obj/structure/stairs/south,
/turf/open/floor/iron,
/area/station/maintenance/tram/left)
"v" = (
/obj/effect/turf_decal/trimline/neutral/filled/line,
/obj/effect/decal/cleanable/dirt,
/obj/effect/turf_decal/siding/thinplating{
	dir = 1
	},
/obj/structure/cable,
/obj/effect/turf_decal/trimline/white/warning{
	dir = 1
	},
/turf/open/floor/iron,
/area/station/maintenance/tram/left)
"w" = (
/obj/effect/decal/cleanable/dirt,
/turf/open/floor/iron/white,
/area/station/maintenance/tram/left)
"y" = (
/obj/effect/decal/cleanable/dirt,
/obj/structure/lattice/catwalk,
/obj/effect/turf_decal/stripes/white/line{
	dir = 1
	},
/obj/effect/turf_decal/stripes/white/line,
/turf/open/floor/plating,
/area/station/maintenance/tram/left)
"z" = (
/obj/effect/decal/cleanable/dirt,
/obj/structure/lattice/catwalk,
/obj/structure/disposalpipe/segment,
/obj/structure/cable,
/turf/open/floor/plating,
/area/station/maintenance/tram/left)
"A" = (
/obj/effect/decal/cleanable/dirt,
/obj/structure/lattice/catwalk,
/obj/effect/turf_decal/stripes/white/line{
	dir = 1
	},
/obj/effect/turf_decal/stripes/white/line,
/obj/structure/disposalpipe/segment,
/obj/structure/cable,
/obj/effect/landmark/event_spawn,
/turf/open/floor/plating,
/area/station/maintenance/tram/left)
"D" = (
/obj/machinery/atmospherics/pipe/smart/manifold4w/scrubbers/hidden/layer2,
/obj/machinery/atmospherics/pipe/smart/manifold4w/supply/hidden/layer4,
/turf/closed/wall,
/area/station/maintenance/port/central)
"F" = (
/obj/effect/turf_decal/trimline/neutral/filled/line{
	dir = 1
	},
/obj/effect/decal/cleanable/dirt,
/obj/effect/turf_decal/stripes/line{
	dir = 1
	},
/obj/structure/lattice/catwalk,
/obj/effect/turf_decal/siding/thinplating,
/obj/machinery/atmospherics/pipe/smart/manifold4w/supply/hidden/layer4,
/obj/machinery/atmospherics/pipe/smart/manifold4w/scrubbers/hidden/layer2,
/obj/effect/turf_decal/trimline/white/warning,
/turf/open/floor/iron,
/area/station/maintenance/tram/left)
"G" = (
/turf/closed/wall,
/area/station/maintenance/port/central)
"H" = (
/obj/effect/turf_decal/trimline/neutral/filled/line{
	dir = 1
	},
/obj/effect/decal/cleanable/dirt,
/obj/effect/turf_decal/stripes/corner{
	dir = 4
	},
/obj/machinery/airalarm/directional/north,
/obj/effect/turf_decal/siding/thinplating,
/obj/structure/disposalpipe/segment{
	dir = 4
	},
/obj/machinery/atmospherics/pipe/smart/manifold4w/supply/hidden/layer4,
/obj/machinery/atmospherics/pipe/smart/manifold4w/scrubbers/hidden/layer2,
/obj/structure/cable,
/obj/effect/turf_decal/trimline/white/warning,
/obj/structure/railing{
	dir = 8
	},
/turf/open/floor/iron,
/area/station/maintenance/tram/left)
"J" = (
/obj/effect/turf_decal/trimline/neutral/filled/corner{
	dir = 8
	},
/obj/effect/turf_decal/trimline/neutral/filled/corner,
/obj/effect/decal/cleanable/dirt,
/obj/effect/turf_decal/siding/thinplating{
	dir = 1
	},
/obj/structure/disposalpipe/segment,
/obj/machinery/atmospherics/pipe/smart/manifold4w/supply/hidden/layer4,
/obj/machinery/atmospherics/pipe/smart/manifold4w/scrubbers/hidden/layer2,
/obj/structure/cable,
/obj/effect/turf_decal/trimline/white/warning{
	dir = 1
	},
/turf/open/floor/iron,
/area/station/maintenance/tram/left)
"K" = (
/obj/effect/turf_decal/trimline/neutral/filled/line{
	dir = 1
	},
/obj/effect/decal/cleanable/dirt,
/obj/effect/turf_decal/stripes/line{
	dir = 1
	},
/obj/effect/turf_decal/caution/stand_clear/red,
/obj/effect/turf_decal/siding/thinplating,
/obj/machinery/atmospherics/pipe/smart/manifold4w/supply/hidden/layer4,
/obj/machinery/atmospherics/pipe/smart/manifold4w/scrubbers/hidden/layer2,
/obj/effect/turf_decal/trimline/white/warning,
/turf/open/floor/iron,
/area/station/maintenance/tram/left)
"L" = (
/obj/effect/turf_decal/trimline/neutral/filled/line,
/obj/effect/decal/cleanable/dirt,
/obj/machinery/camera/directional/south{
	c_tag = "Maintenance - West Tram Tunnel 1"
	},
/obj/effect/turf_decal/siding/thinplating{
	dir = 1
	},
/obj/structure/cable,
/obj/effect/turf_decal/trimline/white/warning{
	dir = 1
	},
/obj/machinery/light/small/dim/directional/south,
/turf/open/floor/iron,
/area/station/maintenance/tram/left)
"M" = (
/obj/effect/decal/cleanable/dirt,
/obj/machinery/atmospherics/components/unary/vent_pump/on/layer4,
/turf/open/floor/iron/white,
/area/station/maintenance/tram/left)
"N" = (
/obj/effect/decal/cleanable/dirt,
/obj/machinery/atmospherics/pipe/smart/manifold4w/scrubbers/hidden/layer2,
/obj/structure/stairs/south,
/obj/machinery/atmospherics/pipe/smart/manifold4w/supply/hidden/layer4,
/turf/open/floor/iron,
/area/station/maintenance/tram/left)
"O" = (
/obj/effect/turf_decal/trimline/neutral/filled/line{
	dir = 1
	},
/obj/effect/decal/cleanable/dirt,
/obj/effect/turf_decal/stripes/line{
	dir = 1
	},
/obj/effect/turf_decal/caution/stand_clear/red,
/obj/effect/turf_decal/siding/thinplating,
/obj/structure/disposalpipe/segment{
	dir = 4
	},
/obj/machinery/atmospherics/pipe/smart/manifold4w/supply/hidden/layer4,
/obj/machinery/atmospherics/pipe/smart/manifold4w/scrubbers/hidden/layer2,
/obj/structure/cable,
/obj/effect/turf_decal/trimline/white/warning,
/turf/open/floor/iron,
/area/station/maintenance/tram/left)
"P" = (
/obj/effect/decal/cleanable/dirt,
/obj/effect/turf_decal/delivery,
/obj/structure/lattice/catwalk,
/obj/machinery/door/poddoor/shutters{
	id = "trammaintdock"
	},
/turf/open/floor/plating,
/area/station/maintenance/port/central)
"Q" = (
/obj/effect/turf_decal/trimline/neutral/filled/line{
	dir = 1
	},
/obj/effect/decal/cleanable/dirt,
/obj/effect/turf_decal/stripes/corner{
	dir = 1
	},
/obj/machinery/button/door/directional/north{
	name = "Tram Maintenance Dock Access";
	pixel_x = -8;
	id = "trammaintdock"
	},
/obj/effect/turf_decal/siding/thinplating,
/obj/machinery/atmospherics/pipe/smart/manifold4w/supply/hidden/layer4,
/obj/machinery/atmospherics/pipe/smart/manifold4w/scrubbers/hidden/layer2,
/obj/effect/turf_decal/trimline/white/warning,
/obj/machinery/light/small/dim/directional/north,
/obj/effect/spawner/random/vending/snackvend{
	pixel_x = -5
	},
/obj/structure/railing{
	dir = 4
	},
/turf/open/floor/iron,
/area/station/maintenance/tram/left)
"R" = (
/obj/effect/decal/cleanable/dirt,
/obj/effect/turf_decal/stripes/white/end{
	dir = 8
	},
/turf/open/floor/plating,
/area/station/maintenance/tram/left)
"S" = (
/obj/effect/turf_decal/trimline/neutral/filled/line{
	dir = 1
	},
/obj/effect/decal/cleanable/dirt,
/obj/effect/turf_decal/stripes/line{
	dir = 1
	},
/obj/structure/lattice/catwalk,
/obj/effect/turf_decal/siding/thinplating,
/obj/structure/disposalpipe/segment{
	dir = 4
	},
/obj/machinery/atmospherics/pipe/smart/manifold4w/supply/hidden/layer4,
/obj/machinery/atmospherics/pipe/smart/manifold4w/scrubbers/hidden/layer2,
/obj/structure/cable,
/obj/effect/turf_decal/trimline/white/warning,
/turf/open/floor/iron,
/area/station/maintenance/tram/left)
"T" = (
/obj/effect/turf_decal/trimline/neutral/filled/line,
/obj/effect/decal/cleanable/dirt,
/obj/effect/turf_decal/siding/thinplating{
	dir = 1
	},
/obj/machinery/atmospherics/pipe/smart/manifold4w/supply/hidden/layer4,
/obj/machinery/atmospherics/pipe/smart/manifold4w/scrubbers/hidden/layer2,
/obj/effect/turf_decal/trimline/white/warning{
	dir = 1
	},
/turf/open/floor/iron,
/area/station/maintenance/tram/left)
"U" = (
/obj/effect/turf_decal/trimline/neutral/filled/line{
	dir = 1
	},
/obj/effect/decal/cleanable/dirt,
/obj/structure/sign/warning/docking{
	name = "KEEP CLEAR: TRAM DOCKING AREA sign";
	desc = "A warning sign which reads 'KEEP CLEAR OF TRAM DOCKING AREA'.";
	pixel_y = 32;
	dir = 1
	},
/obj/effect/turf_decal/siding/thinplating,
/obj/structure/disposalpipe/segment{
	dir = 4
	},
/obj/machinery/atmospherics/pipe/smart/manifold4w/supply/hidden/layer4,
/obj/machinery/atmospherics/pipe/smart/manifold4w/scrubbers/hidden/layer2,
/obj/structure/cable,
/obj/effect/turf_decal/trimline/white/warning,
/obj/structure/railing{
	dir = 4
	},
/turf/open/floor/iron,
/area/station/maintenance/tram/left)
"V" = (
/turf/closed/wall,
/area/station/maintenance/tram/left)
"W" = (
/obj/effect/decal/cleanable/dirt,
/obj/machinery/atmospherics/components/unary/vent_scrubber/on/layer2{
	dir = 1
	},
/turf/open/floor/plating,
/area/station/maintenance/tram/left)
"X" = (
/obj/effect/turf_decal/trimline/neutral/filled/line,
/obj/effect/decal/cleanable/dirt,
/obj/item/assembly/mousetrap/armed,
/obj/machinery/power/apc/auto_name/directional/south,
/obj/effect/turf_decal/siding/thinplating{
	dir = 1
	},
/obj/structure/cable,
/obj/effect/turf_decal/trimline/white/warning{
	dir = 1
	},
/obj/structure/railing{
	dir = 4
	},
/turf/open/floor/iron,
/area/station/maintenance/tram/left)
"Y" = (
/obj/effect/decal/cleanable/dirt,
/obj/effect/turf_decal/trimline/neutral/filled/line{
	dir = 1
	},
/obj/effect/turf_decal/siding/thinplating,
/obj/machinery/atmospherics/pipe/smart/manifold4w/supply/hidden/layer4,
/obj/machinery/atmospherics/pipe/smart/manifold4w/scrubbers/hidden/layer2,
/obj/effect/turf_decal/trimline/white/warning,
/obj/machinery/light/small/dim/directional/north,
/mob/living/basic/bot/medbot/autopatrol{
	name = "T.R.A.M Unit";
	desc = "A Trauma Response Activation Medibot. It seems overwhelmed."
	},
/obj/structure/railing{
	dir = 8
	},
/turf/open/floor/iron,
/area/station/maintenance/tram/left)

(1,1,1) = {"
V
U
W
m
m
m
m
X
"}
(2,1,1) = {"
G
j
w
w
w
w
w
u
"}
(3,1,1) = {"
G
H
m
m
R
m
m
o
"}
(4,1,1) = {"
P
S
e
e
y
e
e
v
"}
(5,1,1) = {"
l
O
m
m
f
m
m
v
"}
(6,1,1) = {"
l
r
m
m
f
m
m
v
"}
(7,1,1) = {"
l
r
m
m
f
m
m
L
"}
(8,1,1) = {"
P
p
z
z
A
z
z
J
"}
(9,1,1) = {"
l
d
m
m
f
m
m
a
"}
(10,1,1) = {"
l
d
m
m
f
m
m
T
"}
(11,1,1) = {"
l
K
m
m
f
m
m
T
"}
(12,1,1) = {"
P
F
e
e
y
e
e
T
"}
(13,1,1) = {"
G
Q
m
m
f
m
m
h
"}
(14,1,1) = {"
D
c
w
w
b
w
M
N
"}
(15,1,1) = {"
G
Y
i
m
f
m
i
t
"}
