//MAP CONVERTED BY dmm2tgm.py THIS HEADER COMMENT PREVENTS RECONVERSION, DO NOT REMOVE
"ab" = (
/obj/machinery/light/directional/west,
/turf/open/openspace,
/area/station/hallway/primary/tram/center)
"aq" = (
/turf/closed/wall,
/area/station/hallway/primary/tram/center)
"aP" = (
/obj/structure/disposalpipe/sorting/mail/flip{
	dir = 4
	},
/obj/effect/mapping_helpers/mail_sorting/service/kitchen,
/obj/effect/mapping_helpers/mail_sorting/service/theater,
/obj/structure/cable,
/obj/machinery/atmospherics/pipe/smart/manifold4w/supply/hidden/layer4,
/obj/effect/turf_decal/trimline/tram/filled/line,
/obj/effect/turf_decal/trimline/tram/filled/warning,
/turf/open/floor/iron,
/area/station/hallway/primary/tram/center)
"bh" = (
/obj/structure/sign/directions/upload{
	dir = 4;
	pixel_y = 14
	},
/obj/structure/sign/directions/engineering{
	pixel_y = 7
	},
/obj/structure/sign/directions/medical{
	pixel_y = -7
	},
/obj/structure/sign/directions/evac{
	dir = 4
	},
/turf/closed/wall,
/area/station/hallway/primary/tram/center)
"bT" = (
/obj/machinery/camera/directional/west{
	c_tag = "Hallway - Central Tram Platform North"
	},
/obj/machinery/light/directional/west,
/turf/open/floor/noslip/tram,
/area/station/hallway/primary/tram/center)
"ep" = (
/turf/open/floor/noslip/tram,
/area/station/hallway/primary/tram/center)
"eD" = (
/obj/structure/disposalpipe/segment{
	dir = 4
	},
/obj/structure/cable,
/obj/machinery/atmospherics/components/unary/vent_pump/on/layer4{
	dir = 4
	},
/obj/effect/turf_decal/trimline/tram/filled/corner,
/obj/effect/turf_decal/trimline/tram/corner,
/turf/open/floor/iron,
/area/station/hallway/primary/tram/center)
"eM" = (
/obj/effect/turf_decal/stripes/white/line{
	dir = 1
	},
/obj/machinery/transport/crossing_signal/southwest,
/obj/structure/railing{
	dir = 4
	},
/turf/open/floor/iron,
/area/station/hallway/primary/tram/center)
"fo" = (
/obj/structure/fluff/tram_rail/electric{
	dir = 1
	},
/turf/open/openspace,
/area/station/hallway/primary/tram/center)
"gx" = (
/obj/structure/disposalpipe/junction/flip{
	dir = 4
	},
/obj/structure/cable,
/obj/machinery/atmospherics/pipe/smart/manifold4w/supply/hidden/layer4,
/obj/machinery/atmospherics/pipe/smart/manifold4w/scrubbers/hidden/layer2,
/obj/effect/turf_decal/trimline/tram/filled/line,
/obj/effect/turf_decal/trimline/tram/filled/warning,
/turf/open/floor/iron,
/area/station/hallway/primary/tram/center)
"hW" = (
/obj/effect/turf_decal/trimline/tram/filled/corner{
	dir = 4
	},
/obj/effect/turf_decal/trimline/tram/corner{
	dir = 4
	},
/turf/open/floor/iron,
/area/station/hallway/primary/tram/center)
"ip" = (
/obj/effect/turf_decal/stripes/white/line,
/obj/machinery/transport/crossing_signal/northeast,
/obj/structure/railing{
	dir = 8
	},
/turf/open/floor/iron,
/area/station/hallway/primary/tram/center)
"jc" = (
/obj/structure/fluff/tram_rail/electric{
	dir = 1
	},
/obj/structure/transport/linear/tram,
/obj/structure/tram,
/turf/open/openspace,
/area/station/hallway/primary/tram/center)
"jz" = (
/obj/effect/turf_decal/tile/neutral/tram,
/obj/structure/transport/linear/tram,
/obj/structure/thermoplastic,
/obj/structure/chair/sofa/bench/tram/left{
	dir = 4
	},
/turf/open/indestructible/tram/plate,
/area/station/hallway/primary/tram/center)
"lE" = (
/obj/effect/turf_decal/tile/neutral/tram,
/obj/structure/transport/linear/tram,
/obj/structure/tram,
/turf/open/indestructible/tram/plate,
/area/station/hallway/primary/tram/center)
"mg" = (
/obj/effect/turf_decal/stripes/white/line{
	dir = 1
	},
/obj/effect/turf_decal/stripes/white/line,
/obj/effect/turf_decal/tile/neutral/tram,
/turf/open/floor/tram/plate/energized{
	inbound = 2;
	outbound = 3
	},
/area/station/hallway/primary/tram/center)
"mK" = (
/obj/machinery/holopad,
/obj/effect/turf_decal/trimline/tram/filled/line{
	dir = 1
	},
/obj/effect/turf_decal/trimline/tram/filled/warning{
	dir = 1
	},
/obj/machinery/button/transport/tram/directional/north{
	id = 2
	},
/obj/machinery/transport/destination_sign/indicator/directional/north,
/turf/open/floor/iron,
/area/station/hallway/primary/tram/center)
"mQ" = (
/obj/structure/sign/directions/vault{
	dir = 8;
	pixel_y = 7
	},
/obj/structure/sign/directions/command{
	dir = 8;
	pixel_y = 14
	},
/obj/structure/sign/directions/security{
	dir = 8;
	pixel_y = -7
	},
/obj/structure/sign/directions/supply{
	dir = 4
	},
/turf/closed/wall,
/area/station/hallway/primary/tram/center)
"nL" = (
/obj/structure/fluff/tram_rail/electric,
/obj/structure/transport/linear/tram,
/obj/structure/thermoplastic/light,
/turf/open/openspace,
/area/station/hallway/primary/tram/center)
"pq" = (
/obj/structure/transport/linear/tram/corner/southwest,
/obj/structure/tram/spoiler,
/turf/open/openspace,
/area/station/hallway/primary/tram/center)
"pA" = (
/obj/structure/transport/linear/tram/corner/northeast,
/obj/structure/tram/spoiler{
	dir = 1
	},
/turf/open/openspace,
/area/station/hallway/primary/tram/center)
"pT" = (
/obj/structure/transport/linear/tram,
/obj/structure/tram,
/turf/open/openspace,
/area/station/hallway/primary/tram/center)
"qz" = (
/obj/machinery/camera/directional/east{
	pixel_y = -23;
	c_tag = "Hallway - Central Tram Platform South"
	},
/obj/machinery/light/directional/east,
/turf/open/floor/noslip/tram,
/area/station/hallway/primary/tram/center)
"sa" = (
/obj/effect/turf_decal/tile/neutral/tram,
/turf/open/indestructible/tram/plate,
/area/station/hallway/primary/tram/center)
"tv" = (
/obj/structure/fluff/tram_rail/electric{
	dir = 1
	},
/obj/structure/transport/linear/tram,
/obj/structure/thermoplastic,
/obj/structure/chair/sofa/bench/tram/left{
	dir = 1
	},
/obj/machinery/computer/tram_controls/split/directional/south,
/turf/open/openspace,
/area/station/hallway/primary/tram/center)
"tz" = (
/obj/structure/transport/linear/tram,
/obj/structure/thermoplastic/light,
/turf/open/openspace,
/area/station/hallway/primary/tram/center)
"uc" = (
/obj/structure/fluff/tram_rail/electric{
	dir = 1
	},
/obj/structure/transport/linear/tram,
/obj/structure/thermoplastic,
/obj/structure/chair/sofa/bench/tram/right{
	dir = 1
	},
/turf/open/openspace,
/area/station/hallway/primary/tram/center)
"uk" = (
/turf/open/floor/iron,
/area/station/hallway/primary/tram/center)
"uy" = (
/obj/structure/fluff/tram_rail/electric,
/obj/structure/transport/linear/tram,
/obj/structure/thermoplastic,
/obj/structure/chair/sofa/bench/tram/right{
	dir = 8
	},
/turf/open/openspace,
/area/station/hallway/primary/tram/center)
"uH" = (
/obj/effect/turf_decal/stripes/white/line{
	dir = 1
	},
/obj/machinery/transport/crossing_signal/southeast,
/obj/structure/railing{
	dir = 8
	},
/turf/open/floor/iron,
/area/station/hallway/primary/tram/center)
"vV" = (
/obj/machinery/light/directional/east,
/turf/open/openspace,
/area/station/hallway/primary/tram/center)
"wq" = (
/obj/effect/turf_decal/tile/neutral/tram,
/obj/structure/transport/linear/tram,
/obj/structure/thermoplastic/light,
/turf/open/indestructible/tram/plate,
/area/station/hallway/primary/tram/center)
"xf" = (
/obj/structure/fluff/tram_rail/electric{
	dir = 1
	},
/obj/structure/transport/linear/tram,
/obj/structure/thermoplastic/light,
/turf/open/openspace,
/area/station/hallway/primary/tram/center)
"xu" = (
/obj/structure/fluff/tram_rail/electric,
/obj/structure/transport/linear/tram,
/obj/structure/tram,
/turf/open/openspace,
/area/station/hallway/primary/tram/center)
"zL" = (
/turf/open/openspace,
/area/station/hallway/primary/tram/center)
"zO" = (
/obj/effect/turf_decal/tile/neutral/tram,
/obj/structure/transport/linear/tram,
/obj/structure/thermoplastic,
/obj/structure/chair/sofa/bench/tram/left{
	dir = 8
	},
/turf/open/indestructible/tram/plate,
/area/station/hallway/primary/tram/center)
"Ax" = (
/obj/structure/transport/linear/tram/corner/southeast,
/obj/structure/tram/spoiler{
	dir = 4
	},
/turf/open/openspace,
/area/station/hallway/primary/tram/center)
"AA" = (
/obj/structure/transport/linear/tram/corner/northwest,
/obj/structure/tram/spoiler{
	dir = 8
	},
/turf/open/openspace,
/area/station/hallway/primary/tram/center)
"Bh" = (
/obj/effect/landmark/start/hangover,
/obj/effect/turf_decal/tile/neutral/tram,
/obj/structure/transport/linear/tram,
/obj/structure/thermoplastic/light,
/turf/open/indestructible/tram/plate,
/area/station/hallway/primary/tram/center)
"Bn" = (
/obj/effect/turf_decal/trimline/tram/filled/corner{
	dir = 1
	},
/obj/effect/turf_decal/trimline/tram/corner{
	dir = 1
	},
/turf/open/floor/iron,
/area/station/hallway/primary/tram/center)
"BA" = (
/obj/effect/turf_decal/stripes/white/line,
/obj/machinery/transport/crossing_signal/northwest,
/obj/structure/railing{
	dir = 4
	},
/turf/open/floor/iron,
/area/station/hallway/primary/tram/center)
"BF" = (
/obj/machinery/light/directional/west,
/turf/open/floor/noslip/tram,
/area/station/hallway/primary/tram/center)
"CX" = (
/obj/effect/turf_decal/stripes/white/line{
	dir = 1
	},
/obj/effect/turf_decal/stripes/white/line,
/obj/effect/turf_decal/tile/neutral/tram,
/turf/open/floor/tram/plate/energized{
	inbound = 1;
	outbound = 2
	},
/area/station/hallway/primary/tram/center)
"Ds" = (
/obj/effect/turf_decal/trimline/tram/filled/line{
	dir = 1
	},
/obj/effect/turf_decal/trimline/tram/filled/warning{
	dir = 1
	},
/turf/open/floor/iron,
/area/station/hallway/primary/tram/center)
"Dv" = (
/obj/structure/transport/linear/tram,
/obj/structure/thermoplastic/light,
/obj/machinery/door/airlock/tram,
/turf/open/openspace,
/area/station/hallway/primary/tram/center)
"DD" = (
/obj/machinery/holopad,
/obj/structure/disposalpipe/segment{
	dir = 4
	},
/obj/structure/cable,
/obj/machinery/atmospherics/pipe/smart/manifold4w/supply/hidden/layer4,
/obj/effect/turf_decal/trimline/tram/filled/line,
/obj/effect/turf_decal/trimline/tram/filled/warning,
/obj/machinery/button/transport/tram/directional/south{
	id = 2
	},
/obj/machinery/transport/destination_sign/indicator/directional/south,
/obj/effect/landmark/observer_start,
/turf/open/floor/iron,
/area/station/hallway/primary/tram/center)
"DN" = (
/obj/structure/transport/linear/tram,
/obj/structure/tram/split,
/obj/machinery/transport/destination_sign/split/south,
/turf/open/openspace,
/area/station/hallway/primary/tram/center)
"DX" = (
/obj/structure/fluff/tram_rail/electric,
/turf/open/openspace,
/area/station/hallway/primary/tram/center)
"Ff" = (
/obj/structure/sign/directions/upload{
	dir = 4;
	pixel_y = -7
	},
/obj/structure/sign/directions/engineering{
	pixel_y = 7
	},
/obj/structure/sign/directions/medical{
	pixel_y = 14
	},
/obj/structure/sign/directions/evac{
	dir = 4
	},
/turf/closed/wall,
/area/station/hallway/primary/tram/center)
"Gv" = (
/obj/effect/turf_decal/tile/neutral/tram,
/obj/structure/transport/linear/tram,
/obj/effect/landmark/transport/nav_beacon/tram/nav/tramstation/main,
/obj/effect/landmark/transport/nav_beacon/tram/platform/tramstation/central,
/obj/structure/thermoplastic/light,
/turf/open/indestructible/tram/plate,
/area/station/hallway/primary/tram/center)
"Hq" = (
/obj/structure/disposalpipe/segment{
	dir = 4
	},
/obj/machinery/atmospherics/pipe/smart/manifold4w/scrubbers/hidden/layer2,
/obj/effect/turf_decal/trimline/tram/filled/line,
/obj/effect/turf_decal/trimline/tram/filled/warning,
/turf/open/floor/iron,
/area/station/hallway/primary/tram/center)
"HS" = (
/obj/structure/disposalpipe/segment{
	dir = 4
	},
/obj/structure/cable,
/obj/machinery/atmospherics/pipe/smart/manifold4w/supply/hidden/layer4,
/obj/effect/turf_decal/trimline/tram/filled/line,
/obj/effect/turf_decal/trimline/tram/filled/warning,
/turf/open/floor/iron,
/area/station/hallway/primary/tram/center)
"IB" = (
/obj/structure/transport/linear/tram,
/obj/structure/tram/split,
/turf/open/openspace,
/area/station/hallway/primary/tram/center)
"Kw" = (
/obj/structure/fluff/tram_rail/electric,
/obj/structure/transport/linear/tram,
/obj/structure/thermoplastic,
/obj/structure/chair/sofa/bench/tram/left,
/obj/machinery/computer/tram_controls/split/directional/north,
/turf/open/openspace,
/area/station/hallway/primary/tram/center)
"ML" = (
/obj/structure/fluff/tram_rail/electric{
	dir = 1
	},
/obj/structure/transport/linear/tram,
/obj/structure/thermoplastic,
/obj/structure/chair/sofa/bench/tram/right{
	dir = 4
	},
/turf/open/openspace,
/area/station/hallway/primary/tram/center)
"Oo" = (
/obj/structure/disposalpipe/segment{
	dir = 4
	},
/turf/open/floor/iron,
/area/station/hallway/primary/tram/center)
"OH" = (
/turf/open/floor/glass/reinforced/tram,
/area/station/hallway/primary/tram/center)
"Pj" = (
/obj/effect/turf_decal/tile/neutral/tram,
/obj/effect/landmark/transport/transport_id/tramstation/line_1,
/obj/structure/transport/linear/tram,
/obj/structure/thermoplastic/light,
/turf/open/indestructible/tram/plate,
/area/station/hallway/primary/tram/center)
"Pz" = (
/obj/structure/fluff/tram_rail/floor{
	dir = 1
	},
/turf/open/floor/glass/reinforced/tram,
/area/station/hallway/primary/tram/center)
"PS" = (
/obj/structure/fluff/tram_rail,
/obj/structure/transport/linear/tram,
/obj/structure/thermoplastic/light,
/turf/open/openspace,
/area/station/hallway/primary/tram/center)
"Qp" = (
/obj/structure/fluff/tram_rail/electric{
	dir = 1
	},
/obj/structure/transport/linear/tram,
/obj/structure/thermoplastic,
/obj/structure/sign/tram_plate/directional/south,
/turf/open/openspace,
/area/station/hallway/primary/tram/center)
"QZ" = (
/obj/structure/fluff/tram_rail/electric,
/obj/structure/transport/linear/tram,
/obj/structure/thermoplastic,
/turf/open/openspace,
/area/station/hallway/primary/tram/center)
"Rk" = (
/obj/structure/fluff/tram_rail/electric/anchor{
	dir = 1
	},
/obj/structure/transport/linear/tram,
/obj/structure/thermoplastic,
/obj/structure/chair/sofa/bench/tram{
	dir = 1
	},
/turf/open/openspace,
/area/station/hallway/primary/tram/center)
"RL" = (
/obj/structure/transport/linear/tram,
/obj/structure/tram/split,
/obj/machinery/transport/destination_sign/split/north,
/turf/open/openspace,
/area/station/hallway/primary/tram/center)
"Sv" = (
/obj/structure/disposalpipe/segment{
	dir = 4
	},
/obj/machinery/atmospherics/pipe/smart/manifold4w/supply/hidden/layer4,
/obj/structure/cable,
/obj/effect/turf_decal/trimline/tram/filled/line,
/obj/effect/turf_decal/trimline/tram/filled/warning,
/turf/open/floor/iron,
/area/station/hallway/primary/tram/center)
"SF" = (
/obj/structure/disposalpipe/segment{
	dir = 4
	},
/obj/structure/cable,
/turf/open/floor/iron,
/area/station/hallway/primary/tram/center)
"To" = (
/obj/structure/fluff/tram_rail/electric/anchor,
/obj/structure/transport/linear/tram,
/obj/structure/thermoplastic,
/obj/structure/chair/sofa/bench/tram,
/turf/open/openspace,
/area/station/hallway/primary/tram/center)
"Tw" = (
/obj/structure/fluff/tram_rail/electric,
/obj/structure/transport/linear/tram,
/obj/structure/thermoplastic,
/obj/structure/chair/sofa/bench/tram/right,
/turf/open/openspace,
/area/station/hallway/primary/tram/center)
"TZ" = (
/obj/machinery/light/directional/east,
/turf/open/floor/noslip/tram,
/area/station/hallway/primary/tram/center)
"Un" = (
/obj/structure/fluff/tram_rail/floor,
/turf/open/floor/glass/reinforced/tram,
/area/station/hallway/primary/tram/center)
"VK" = (
/obj/structure/transport/linear/tram,
/obj/structure/tram,
/obj/machinery/transport/tram_controller,
/turf/open/openspace,
/area/station/hallway/primary/tram/center)
"WP" = (
/obj/structure/disposalpipe/segment{
	dir = 4
	},
/obj/machinery/atmospherics/components/unary/vent_scrubber/on/layer2{
	dir = 8
	},
/obj/effect/turf_decal/trimline/tram/filled/corner{
	dir = 8
	},
/obj/effect/turf_decal/trimline/tram/corner{
	dir = 8
	},
/turf/open/floor/iron,
/area/station/hallway/primary/tram/center)

(1,1,1) = {"
SF
BA
OH
Un
CX
Pz
OH
eM
uk
"}
(2,1,1) = {"
eD
vV
zL
DX
sa
fo
zL
vV
hW
"}
(3,1,1) = {"
Sv
mQ
AA
xu
lE
jc
pq
mQ
Ds
"}
(4,1,1) = {"
Sv
bT
VK
QZ
jz
ML
pT
BF
Ds
"}
(5,1,1) = {"
Sv
ep
Dv
nL
wq
xf
Dv
ep
Ds
"}
(6,1,1) = {"
aP
ep
tz
nL
Bh
xf
tz
ep
Ds
"}
(7,1,1) = {"
HS
ep
IB
Tw
Pj
tv
DN
ep
Ds
"}
(8,1,1) = {"
DD
aq
IB
To
Gv
Rk
IB
aq
mK
"}
(9,1,1) = {"
HS
ep
RL
Kw
wq
uc
IB
ep
Ds
"}
(10,1,1) = {"
gx
ep
Dv
PS
Bh
xf
Dv
ep
Ds
"}
(11,1,1) = {"
Hq
ep
tz
nL
wq
xf
tz
ep
Ds
"}
(12,1,1) = {"
Hq
TZ
pT
uy
zO
Qp
pT
qz
Ds
"}
(13,1,1) = {"
Hq
bh
pA
xu
lE
jc
Ax
Ff
Ds
"}
(14,1,1) = {"
WP
ab
zL
DX
sa
fo
zL
ab
Bn
"}
(15,1,1) = {"
Oo
ip
OH
Un
mg
Pz
OH
uH
uk
"}
