//MAP CONVERTED BY dmm2tgm.py THIS HEADER COMMENT PREVENTS RECONVERSION, DO NOT REMOVE
"a" = (
/obj/effect/decal/cleanable/dirt,
/obj/effect/turf_decal/trimline/neutral/filled/line{
	dir = 1
	},
/obj/effect/turf_decal/siding/thinplating,
/obj/machinery/atmospherics/pipe/smart/manifold4w/supply/hidden/layer4,
/obj/machinery/atmospherics/pipe/smart/manifold4w/scrubbers/hidden/layer2,
/obj/effect/turf_decal/trimline/white/warning,
/turf/open/floor/iron,
/area/station/maintenance/tram/right)
"b" = (
/obj/effect/turf_decal/trimline/neutral/filled/corner,
/obj/effect/turf_decal/trimline/neutral/filled/corner{
	dir = 8
	},
/obj/effect/turf_decal/siding/thinplating{
	dir = 1
	},
/obj/effect/turf_decal/trimline/white/warning{
	dir = 1
	},
/obj/effect/decal/cleanable/dirt,
/obj/structure/cable,
/obj/machinery/atmospherics/pipe/smart/manifold4w/supply/hidden/layer4,
/obj/machinery/atmospherics/pipe/smart/manifold4w/scrubbers/hidden/layer2,
/turf/open/floor/iron,
/area/station/maintenance/tram/right)
"c" = (
/obj/effect/decal/cleanable/dirt,
/obj/effect/turf_decal/trimline/neutral/filled/line{
	dir = 1
	},
/obj/effect/turf_decal/bot_red,
/obj/effect/turf_decal/siding/thinplating,
/obj/machinery/atmospherics/pipe/smart/manifold4w/scrubbers/hidden/layer2,
/obj/effect/turf_decal/trimline/white/warning,
/obj/structure/railing{
	dir = 8
	},
/turf/open/floor/iron,
/area/station/maintenance/tram/right)
"d" = (
/obj/effect/decal/cleanable/dirt,
/obj/machinery/atmospherics/components/unary/vent_scrubber/on/layer2{
	dir = 1
	},
/turf/open/floor/plating,
/area/station/maintenance/tram/right)
"e" = (
/obj/effect/decal/cleanable/dirt,
/obj/effect/turf_decal/trimline/neutral/filled/line,
/obj/effect/turf_decal/siding/thinplating{
	dir = 1
	},
/obj/effect/turf_decal/trimline/white/warning{
	dir = 1
	},
/obj/structure/railing{
	dir = 4
	},
/turf/open/floor/iron,
/area/station/maintenance/tram/right)
"f" = (
/obj/effect/decal/cleanable/dirt,
/obj/effect/turf_decal/trimline/neutral/filled/line{
	dir = 1
	},
/obj/effect/spawner/random/trash/graffiti{
	pixel_y = 32;
	spawn_loot_chance = 50
	},
/obj/effect/turf_decal/siding/thinplating,
/obj/machinery/atmospherics/pipe/smart/manifold4w/scrubbers/hidden/layer2,
/obj/effect/turf_decal/trimline/white/warning,
/obj/effect/spawner/random/vending/colavend{
	pixel_x = -5
	},
/obj/structure/railing{
	dir = 4
	},
/turf/open/floor/iron,
/area/station/maintenance/tram/right)
"g" = (
/obj/effect/turf_decal/trimline/neutral/filled/line,
/obj/effect/turf_decal/siding/thinplating{
	dir = 1
	},
/obj/structure/cable,
/obj/effect/turf_decal/trimline/white/warning{
	dir = 1
	},
/obj/effect/decal/cleanable/dirt,
/turf/open/floor/iron,
/area/station/maintenance/tram/right)
"h" = (
/obj/effect/decal/cleanable/dirt,
/obj/machinery/atmospherics/pipe/smart/manifold4w/scrubbers/hidden/layer2,
/obj/machinery/atmospherics/pipe/smart/manifold4w/supply/hidden/layer4,
/obj/structure/stairs/south,
/turf/open/floor/iron,
/area/station/maintenance/tram/right)
"i" = (
/obj/effect/decal/cleanable/dirt,
/obj/effect/turf_decal/trimline/neutral/filled/line{
	dir = 1
	},
/obj/effect/turf_decal/siding/thinplating,
/obj/machinery/atmospherics/pipe/smart/manifold4w/supply/hidden/layer4,
/obj/machinery/atmospherics/pipe/smart/manifold4w/scrubbers/hidden/layer2,
/obj/effect/turf_decal/trimline/white/warning,
/obj/structure/railing{
	dir = 8
	},
/turf/open/floor/iron,
/area/station/maintenance/tram/right)
"j" = (
/obj/effect/decal/cleanable/dirt,
/obj/effect/turf_decal/stripes/white/line{
	dir = 1
	},
/obj/effect/turf_decal/stripes/white/line,
/obj/effect/landmark/event_spawn,
/turf/open/floor/plating,
/area/station/maintenance/tram/right)
"k" = (
/obj/effect/decal/cleanable/dirt,
/obj/effect/turf_decal/trimline/neutral/filled/corner{
	dir = 1
	},
/obj/effect/turf_decal/trimline/neutral/filled/corner{
	dir = 4
	},
/obj/effect/turf_decal/siding/thinplating,
/obj/machinery/atmospherics/pipe/smart/manifold4w/scrubbers/hidden/layer2,
/obj/machinery/atmospherics/pipe/smart/manifold4w/supply/hidden/layer4,
/obj/structure/cable,
/obj/effect/turf_decal/trimline/white/warning,
/turf/open/floor/iron,
/area/station/maintenance/tram/right)
"l" = (
/obj/effect/decal/cleanable/dirt,
/obj/effect/turf_decal/trimline/neutral/filled/line,
/obj/effect/turf_decal/siding/thinplating{
	dir = 1
	},
/obj/structure/cable,
/obj/effect/turf_decal/trimline/white/warning{
	dir = 1
	},
/obj/effect/spawner/random/trash/graffiti{
	pixel_y = -32;
	spawn_loot_chance = 50
	},
/turf/open/floor/iron,
/area/station/maintenance/tram/right)
"o" = (
/obj/effect/decal/cleanable/dirt,
/obj/effect/turf_decal/stripes/white/line{
	dir = 1
	},
/obj/effect/turf_decal/stripes/white/line,
/turf/open/floor/plating,
/area/station/maintenance/tram/right)
"p" = (
/obj/effect/decal/cleanable/dirt,
/obj/effect/turf_decal/trimline/neutral/filled/line{
	dir = 1
	},
/obj/machinery/camera{
	dir = 9;
	c_tag = "Maintenance - East Tram Tunnel 3"
	},
/obj/effect/turf_decal/siding/thinplating,
/obj/machinery/atmospherics/pipe/smart/manifold4w/supply/hidden/layer4,
/obj/machinery/atmospherics/pipe/smart/manifold4w/scrubbers/hidden/layer2,
/obj/effect/turf_decal/trimline/white/warning,
/obj/machinery/airalarm/directional/north,
/turf/open/floor/iron,
/area/station/maintenance/tram/right)
"q" = (
/obj/effect/decal/cleanable/dirt,
/obj/structure/lattice/catwalk,
/obj/machinery/atmospherics/pipe/smart/manifold4w/scrubbers/hidden/layer2,
/obj/machinery/atmospherics/pipe/smart/manifold4w/supply/hidden/layer4,
/turf/open/floor/plating,
/area/station/maintenance/tram/right)
"t" = (
/obj/effect/decal/cleanable/dirt,
/obj/structure/lattice/catwalk,
/obj/structure/cable,
/turf/open/floor/plating,
/area/station/maintenance/tram/right)
"v" = (
/obj/effect/turf_decal/sand/plating,
/turf/open/floor/plating,
/area/station/maintenance/tram/right)
"w" = (
/obj/effect/decal/cleanable/dirt,
/obj/machinery/atmospherics/components/unary/vent_pump/on/layer4,
/turf/open/floor/iron/white,
/area/station/maintenance/tram/right)
"x" = (
/obj/effect/decal/cleanable/dirt,
/obj/effect/turf_decal/stripes/white/line{
	dir = 1
	},
/obj/effect/turf_decal/stripes/white/line,
/obj/structure/lattice/catwalk,
/obj/structure/cable,
/turf/open/floor/plating,
/area/station/maintenance/tram/right)
"y" = (
/obj/effect/decal/cleanable/dirt,
/obj/effect/turf_decal/trimline/neutral/filled/corner{
	dir = 8
	},
/obj/effect/turf_decal/trimline/neutral/filled/corner,
/obj/effect/turf_decal/siding/thinplating{
	dir = 1
	},
/obj/machinery/atmospherics/pipe/smart/manifold4w/supply/hidden/layer4,
/obj/machinery/atmospherics/pipe/smart/manifold4w/scrubbers/hidden/layer2,
/obj/effect/turf_decal/trimline/white/warning{
	dir = 1
	},
/obj/effect/spawner/random/vending/snackvend{
	pixel_x = 5
	},
/obj/structure/railing{
	dir = 8
	},
/turf/open/floor/iron,
/area/station/maintenance/tram/right)
"z" = (
/mob/living/simple_animal/bot/secbot/beepsky/officer,
/obj/effect/decal/cleanable/dirt,
/obj/effect/turf_decal/trimline/neutral/filled/line,
/obj/machinery/camera/directional/south{
	c_tag = "Maintenance - East Tram Tunnel 4"
	},
/obj/effect/turf_decal/bot_red,
/obj/effect/turf_decal/siding/thinplating{
	dir = 1
	},
/obj/effect/turf_decal/trimline/white/warning{
	dir = 1
	},
/obj/structure/railing{
	dir = 8
	},
/turf/open/floor/iron,
/area/station/maintenance/tram/right)
"A" = (
/obj/effect/decal/cleanable/dirt,
/obj/effect/turf_decal/stripes/white/end{
	dir = 4
	},
/turf/open/floor/plating,
/area/station/maintenance/tram/right)
"B" = (
/obj/effect/decal/cleanable/dirt,
/obj/machinery/atmospherics/pipe/smart/manifold4w/supply/hidden/layer4,
/obj/machinery/atmospherics/pipe/smart/manifold4w/scrubbers/hidden/layer2,
/obj/structure/stairs/north,
/turf/open/floor/iron,
/area/station/maintenance/tram/right)
"C" = (
/obj/effect/turf_decal/trimline/neutral/filled/line,
/obj/effect/turf_decal/siding/thinplating{
	dir = 1
	},
/obj/effect/turf_decal/trimline/white/warning{
	dir = 1
	},
/obj/structure/cable,
/obj/effect/decal/cleanable/dirt,
/obj/machinery/light/small/dim/directional/south,
/turf/open/floor/iron,
/area/station/maintenance/tram/right)
"F" = (
/obj/effect/decal/cleanable/dirt,
/obj/effect/turf_decal/stripes/white/line{
	dir = 1
	},
/obj/effect/turf_decal/stripes/white/line,
/obj/structure/lattice/catwalk,
/turf/open/floor/plating,
/area/station/maintenance/tram/right)
"H" = (
/obj/effect/decal/cleanable/dirt,
/obj/structure/lattice/catwalk,
/turf/open/floor/plating,
/area/station/maintenance/tram/right)
"I" = (
/obj/effect/decal/cleanable/dirt,
/turf/open/floor/iron/white,
/area/station/maintenance/tram/right)
"J" = (
/obj/effect/turf_decal/trimline/neutral/filled/line,
/obj/effect/turf_decal/siding/thinplating{
	dir = 1
	},
/obj/structure/cable,
/obj/effect/turf_decal/trimline/white/warning{
	dir = 1
	},
/obj/machinery/power/apc/auto_name/directional/south,
/obj/effect/decal/cleanable/dirt,
/turf/open/floor/iron,
/area/station/maintenance/tram/right)
"K" = (
/obj/effect/decal/cleanable/dirt,
/obj/effect/turf_decal/trimline/neutral/filled/corner{
	dir = 1
	},
/obj/effect/turf_decal/trimline/neutral/filled/corner{
	dir = 4
	},
/obj/effect/turf_decal/siding/thinplating,
/obj/machinery/atmospherics/pipe/smart/manifold4w/supply/hidden/layer4,
/obj/machinery/atmospherics/pipe/smart/manifold4w/scrubbers/hidden/layer2,
/obj/effect/turf_decal/trimline/white/warning,
/turf/open/floor/iron,
/area/station/maintenance/tram/right)
"O" = (
/obj/effect/decal/cleanable/dirt,
/obj/effect/turf_decal/trimline/neutral/filled/line,
/obj/effect/landmark/start/hangover,
/obj/effect/turf_decal/siding/thinplating{
	dir = 1
	},
/obj/effect/turf_decal/trimline/white/warning{
	dir = 1
	},
/obj/machinery/atmospherics/pipe/smart/manifold4w/supply/hidden/layer4,
/obj/machinery/atmospherics/pipe/smart/manifold4w/scrubbers/hidden/layer2,
/obj/machinery/light/small/dim/directional/south,
/turf/open/floor/iron,
/area/station/maintenance/tram/right)
"Q" = (
/obj/effect/decal/cleanable/dirt,
/obj/structure/stairs/south,
/turf/open/floor/iron,
/area/station/maintenance/tram/right)
"R" = (
/obj/effect/decal/cleanable/dirt,
/turf/open/floor/plating,
/area/station/maintenance/tram/right)
"S" = (
/obj/effect/decal/cleanable/dirt,
/obj/effect/turf_decal/stripes/white/line{
	dir = 1
	},
/obj/effect/turf_decal/stripes/white/line,
/turf/open/floor/iron/white,
/area/station/maintenance/tram/right)
"T" = (
/obj/effect/decal/cleanable/dirt,
/obj/effect/turf_decal/trimline/neutral/filled/line{
	dir = 1
	},
/obj/effect/turf_decal/siding/thinplating,
/obj/machinery/atmospherics/pipe/smart/manifold4w/scrubbers/hidden/layer2,
/obj/machinery/atmospherics/pipe/smart/manifold4w/supply/hidden/layer4,
/obj/effect/turf_decal/trimline/white/warning,
/obj/structure/railing{
	dir = 4
	},
/turf/open/floor/iron,
/area/station/maintenance/tram/right)
"U" = (
/obj/effect/decal/cleanable/dirt,
/obj/effect/turf_decal/trimline/neutral/filled/line,
/obj/effect/turf_decal/siding/thinplating{
	dir = 1
	},
/obj/machinery/atmospherics/pipe/smart/manifold4w/scrubbers/hidden/layer2,
/obj/machinery/atmospherics/pipe/smart/manifold4w/supply/hidden/layer4,
/obj/effect/turf_decal/trimline/white/warning{
	dir = 1
	},
/obj/structure/railing{
	dir = 4
	},
/turf/open/floor/iron,
/area/station/maintenance/tram/right)
"V" = (
/obj/effect/decal/cleanable/dirt,
/obj/effect/turf_decal/trimline/neutral/filled/line,
/obj/effect/turf_decal/siding/thinplating{
	dir = 1
	},
/obj/effect/turf_decal/trimline/white/warning{
	dir = 1
	},
/obj/machinery/atmospherics/pipe/smart/manifold4w/supply/hidden/layer4,
/obj/machinery/atmospherics/pipe/smart/manifold4w/scrubbers/hidden/layer2,
/turf/open/floor/iron,
/area/station/maintenance/tram/right)
"W" = (
/obj/effect/decal/cleanable/dirt,
/obj/effect/turf_decal/trimline/neutral/filled/line{
	dir = 1
	},
/obj/effect/turf_decal/siding/thinplating,
/obj/machinery/atmospherics/pipe/smart/manifold4w/scrubbers/hidden/layer2,
/obj/structure/cable,
/obj/effect/turf_decal/trimline/white/warning,
/obj/machinery/light/small/dim/directional/north,
/turf/open/floor/iron,
/area/station/maintenance/tram/right)
"Y" = (
/obj/effect/decal/cleanable/dirt,
/obj/effect/turf_decal/trimline/neutral/filled/line{
	dir = 1
	},
/obj/effect/turf_decal/siding/thinplating,
/obj/machinery/atmospherics/pipe/smart/manifold4w/supply/hidden/layer4,
/obj/machinery/atmospherics/pipe/smart/manifold4w/scrubbers/hidden/layer2,
/obj/effect/turf_decal/trimline/white/warning,
/obj/machinery/light/small/dim/directional/north,
/turf/open/floor/iron,
/area/station/maintenance/tram/right)
"Z" = (
/obj/effect/decal/cleanable/dirt,
/obj/item/assembly/mousetrap,
/obj/item/food/deadmouse,
/obj/machinery/atmospherics/pipe/smart/manifold4w/scrubbers/hidden/layer2,
/obj/structure/stairs/north,
/turf/open/floor/iron,
/area/station/maintenance/tram/right)

(1,1,1) = {"
T
q
R
o
v
q
U
"}
(2,1,1) = {"
B
I
I
S
I
w
h
"}
(3,1,1) = {"
i
R
R
o
R
R
y
"}
(4,1,1) = {"
Y
H
H
F
H
H
V
"}
(5,1,1) = {"
K
R
R
o
R
R
V
"}
(6,1,1) = {"
Y
R
R
o
R
R
V
"}
(7,1,1) = {"
a
R
R
o
R
R
O
"}
(8,1,1) = {"
p
R
R
j
R
R
b
"}
(9,1,1) = {"
a
R
R
o
R
R
C
"}
(10,1,1) = {"
Y
R
R
o
R
R
J
"}
(11,1,1) = {"
k
R
R
o
R
R
l
"}
(12,1,1) = {"
W
t
t
x
t
t
g
"}
(13,1,1) = {"
f
R
R
A
R
R
e
"}
(14,1,1) = {"
Z
I
I
I
I
I
Q
"}
(15,1,1) = {"
c
d
R
R
R
R
z
"}
