//MAP CONVERTED BY dmm2tgm.py THIS HEADER COMMENT PREVENTS RECONVERSION, DO NOT REMOVE
"a" = (
/obj/structure/fluff/tram_rail/electric{
	dir = 1
	},
/turf/open/openspace,
/area/station/hallway/primary/tram/right)
"f" = (
/obj/machinery/camera/directional/west{
	c_tag = "Hallway - Starboard Tram Platform North"
	},
/obj/machinery/light/directional/west,
/turf/open/floor/noslip/tram,
/area/station/hallway/primary/tram/right)
"h" = (
/obj/machinery/light/directional/west,
/turf/open/floor/noslip/tram,
/area/station/hallway/primary/tram/right)
"i" = (
/obj/structure/fluff/tram_rail/electric,
/turf/open/openspace,
/area/station/hallway/primary/tram/right)
"k" = (
/obj/effect/turf_decal/stripes/white/line{
	dir = 1
	},
/obj/effect/turf_decal/stripes/white/line,
/obj/effect/turf_decal/tile/neutral/tram,
/turf/open/floor/tram/plate/energized{
	inbound = 2;
	outbound = 3
	},
/area/station/hallway/primary/tram/right)
"l" = (
/obj/effect/turf_decal/tile/neutral/tram,
/turf/open/indestructible/tram/plate,
/area/station/hallway/primary/tram/right)
"n" = (
/obj/structure/sign/directions/vault{
	dir = 8;
	pixel_y = 7
	},
/obj/structure/sign/directions/command{
	dir = 8;
	pixel_y = 14
	},
/obj/structure/sign/directions/security{
	dir = 8;
	pixel_y = -7
	},
/obj/structure/sign/directions/supply{
	dir = 1
	},
/turf/closed/wall,
/area/station/hallway/primary/tram/right)
"p" = (
/obj/machinery/light/directional/east,
/turf/open/openspace,
/area/station/hallway/primary/tram/right)
"q" = (
/obj/structure/fluff/tram_rail/electric/anchor,
/turf/open/openspace,
/area/station/hallway/primary/tram/right)
"r" = (
/obj/structure/sign/directions/vault{
	dir = 8;
	pixel_y = 7
	},
/obj/structure/sign/directions/command{
	dir = 8;
	pixel_y = -7
	},
/obj/structure/sign/directions/security{
	dir = 8;
	pixel_y = 14
	},
/obj/structure/sign/directions/supply{
	dir = 1
	},
/turf/closed/wall,
/area/station/hallway/primary/tram/right)
"s" = (
/obj/structure/fluff/tram_rail/end{
	dir = 1
	},
/turf/open/openspace,
/area/station/hallway/primary/tram/right)
"u" = (
/obj/machinery/static_signal/southeast,
/obj/effect/turf_decal/stripes/white/line{
	dir = 1
	},
/obj/structure/railing{
	dir = 8
	},
/turf/open/floor/iron,
/area/station/hallway/primary/tram/right)
"w" = (
/turf/closed/wall,
/area/station/hallway/primary/tram/right)
"x" = (
/obj/effect/turf_decal/stripes/white/line,
/obj/machinery/transport/crossing_signal/northwest,
/obj/structure/railing{
	dir = 4
	},
/turf/open/floor/iron,
/area/station/hallway/primary/tram/right)
"y" = (
/turf/open/floor/glass/reinforced/tram,
/area/station/hallway/primary/tram/right)
"D" = (
/obj/machinery/static_signal/northeast,
/obj/effect/turf_decal/stripes/white/line,
/obj/structure/railing{
	dir = 8
	},
/turf/open/floor/iron,
/area/station/hallway/primary/tram/right)
"F" = (
/obj/machinery/light/directional/west,
/turf/open/openspace,
/area/station/hallway/primary/tram/right)
"I" = (
/obj/structure/fluff/tram_rail/floor,
/turf/open/floor/glass/reinforced/tram,
/area/station/hallway/primary/tram/right)
"J" = (
/obj/structure/fluff/tram_rail/end,
/turf/open/openspace,
/area/station/hallway/primary/tram/right)
"N" = (
/turf/open/floor/noslip/tram,
/area/station/hallway/primary/tram/right)
"O" = (
/obj/machinery/camera/directional/east{
	pixel_y = -23;
	c_tag = "Hallway - Starboard Tram Platform South"
	},
/obj/machinery/light/directional/east,
/turf/open/floor/noslip/tram,
/area/station/hallway/primary/tram/right)
"P" = (
/obj/machinery/light/directional/east,
/turf/open/floor/noslip/tram,
/area/station/hallway/primary/tram/right)
"S" = (
/obj/structure/fluff/tram_rail/floor{
	dir = 1
	},
/turf/open/floor/glass/reinforced/tram,
/area/station/hallway/primary/tram/right)
"T" = (
/obj/effect/turf_decal/stripes/white/line{
	dir = 8
	},
/obj/effect/turf_decal/caution/stand_clear/white{
	dir = 4
	},
/turf/open/indestructible/tram,
/area/station/hallway/primary/tram/right)
"U" = (
/obj/effect/turf_decal/tile/neutral/tram,
/obj/effect/landmark/transport/nav_beacon/tram/platform/tramstation/east,
/turf/open/indestructible/tram/plate,
/area/station/hallway/primary/tram/right)
"V" = (
/turf/open/openspace,
/area/station/hallway/primary/tram/right)
"W" = (
/obj/structure/fluff/tram_rail/electric/anchor{
	dir = 1
	},
/turf/open/openspace,
/area/station/hallway/primary/tram/right)
"X" = (
/obj/effect/turf_decal/stripes/white/line{
	dir = 1
	},
/obj/machinery/transport/crossing_signal/southwest,
/obj/structure/railing{
	dir = 4
	},
/turf/open/floor/iron,
/area/station/hallway/primary/tram/right)
"Y" = (
/obj/structure/sign/directions/upload{
	pixel_y = 7
	},
/obj/structure/sign/directions/engineering{
	dir = 8;
	pixel_y = 14
	},
/obj/structure/sign/directions/medical{
	dir = 8;
	pixel_y = -7
	},
/obj/structure/sign/directions/evac{
	dir = 4
	},
/turf/closed/wall,
/area/station/hallway/primary/tram/right)

(1,1,1) = {"
x
y
I
k
S
y
X
"}
(2,1,1) = {"
p
V
i
l
a
V
p
"}
(3,1,1) = {"
r
V
i
l
a
V
n
"}
(4,1,1) = {"
f
V
i
l
a
V
h
"}
(5,1,1) = {"
N
V
i
l
a
V
N
"}
(6,1,1) = {"
N
V
i
l
a
V
N
"}
(7,1,1) = {"
N
V
i
l
a
V
N
"}
(8,1,1) = {"
w
V
q
U
W
V
w
"}
(9,1,1) = {"
N
V
i
l
a
V
N
"}
(10,1,1) = {"
N
V
i
l
a
V
N
"}
(11,1,1) = {"
N
V
i
l
a
V
N
"}
(12,1,1) = {"
P
V
i
l
a
V
O
"}
(13,1,1) = {"
Y
V
i
l
a
V
Y
"}
(14,1,1) = {"
F
V
J
T
s
V
F
"}
(15,1,1) = {"
D
y
y
y
y
y
u
"}
