//MAP CONVERTED BY dmm2tgm.py THIS HEADER COMMENT PREVENTS RECONVERSION, DO NOT REMOVE
"a" = (
/obj/effect/decal/cleanable/dirt,
/turf/open/floor/plating,
/area/station/maintenance/tram/mid)
"b" = (
/obj/effect/decal/cleanable/dirt,
/obj/effect/decal/cleanable/blood/tracks{
	dir = 10
	},
/turf/open/floor/iron/white,
/area/station/maintenance/tram/mid)
"c" = (
/obj/effect/decal/cleanable/dirt,
/obj/effect/turf_decal/siding/thinplating,
/obj/machinery/atmospherics/pipe/smart/manifold4w/supply/hidden/layer4,
/obj/machinery/atmospherics/pipe/smart/manifold4w/scrubbers/hidden/layer2,
/obj/effect/turf_decal/trimline/white/warning,
/obj/structure/railing{
	dir = 8
	},
/turf/open/floor/iron,
/area/station/maintenance/tram/mid)
"d" = (
/obj/effect/decal/cleanable/dirt,
/obj/effect/turf_decal/trimline/neutral/filled/line,
/obj/effect/spawner/random/trash/graffiti{
	pixel_y = -32;
	spawn_loot_chance = 50
	},
/obj/effect/turf_decal/siding/thinplating{
	dir = 1
	},
/obj/machinery/atmospherics/pipe/smart/manifold4w/supply/hidden/layer4,
/obj/machinery/atmospherics/pipe/smart/manifold4w/scrubbers/hidden/layer2,
/obj/effect/turf_decal/trimline/white/warning{
	dir = 1
	},
/turf/open/floor/iron,
/area/station/maintenance/tram/mid)
"e" = (
/obj/effect/decal/cleanable/dirt,
/obj/effect/turf_decal/stripes/white/line{
	dir = 1
	},
/obj/effect/turf_decal/stripes/white/line,
/obj/effect/decal/cleanable/blood/tracks{
	dir = 5
	},
/turf/open/floor/iron/white,
/area/station/maintenance/tram/mid)
"f" = (
/obj/machinery/atmospherics/pipe/smart/manifold4w/supply/hidden/layer4,
/obj/machinery/atmospherics/pipe/smart/manifold4w/scrubbers/hidden/layer2,
/obj/effect/decal/cleanable/blood/tracks,
/obj/structure/stairs/south,
/turf/open/floor/iron,
/area/station/maintenance/tram/mid)
"g" = (
/obj/effect/decal/cleanable/dirt,
/obj/effect/turf_decal/trimline/neutral/filled/line,
/obj/effect/turf_decal/bot_red,
/obj/effect/turf_decal/siding/thinplating{
	dir = 1
	},
/obj/machinery/atmospherics/pipe/smart/manifold4w/supply/hidden/layer4,
/obj/machinery/atmospherics/pipe/smart/manifold4w/scrubbers/hidden/layer2,
/obj/effect/turf_decal/trimline/white/warning{
	dir = 1
	},
/turf/open/floor/iron,
/area/station/maintenance/tram/mid)
"h" = (
/obj/effect/mapping_helpers/airlock/access/all/engineering/maintenance,
/obj/effect/decal/cleanable/dirt,
/obj/machinery/door/airlock/maintenance_hatch{
	name = "Tunnel Access Hatch"
	},
/obj/effect/mapping_helpers/airlock/unres{
	dir = 1
	},
/obj/structure/disposalpipe/segment,
/obj/machinery/atmospherics/pipe/smart/manifold4w/scrubbers/hidden/layer2,
/obj/machinery/atmospherics/pipe/smart/manifold4w/supply/hidden/layer4,
/obj/structure/cable,
/turf/open/floor/catwalk_floor,
/area/station/maintenance/tram/mid)
"i" = (
/obj/effect/decal/cleanable/dirt,
/obj/structure/lattice/catwalk,
/obj/machinery/atmospherics/pipe/smart/manifold4w/supply/hidden/layer4,
/obj/machinery/atmospherics/pipe/smart/manifold4w/scrubbers/hidden/layer2,
/turf/open/floor/plating,
/area/station/maintenance/tram/mid)
"j" = (
/obj/effect/turf_decal/trimline/neutral/filled/line{
	dir = 1
	},
/obj/effect/decal/cleanable/dirt,
/obj/effect/turf_decal/siding/thinplating,
/obj/structure/disposalpipe/segment{
	dir = 4
	},
/obj/machinery/atmospherics/pipe/smart/manifold4w/supply/hidden/layer4,
/obj/machinery/atmospherics/pipe/smart/manifold4w/scrubbers/hidden/layer2,
/obj/structure/cable,
/obj/effect/turf_decal/trimline/white/warning,
/obj/machinery/light/small/dim/directional/north,
/turf/open/floor/iron,
/area/station/maintenance/tram/mid)
"k" = (
/obj/effect/decal/cleanable/dirt,
/obj/effect/turf_decal/trimline/neutral/filled/line,
/obj/effect/turf_decal/siding/thinplating{
	dir = 1
	},
/obj/machinery/atmospherics/pipe/smart/manifold4w/supply/hidden/layer4,
/obj/machinery/atmospherics/pipe/smart/manifold4w/scrubbers/hidden/layer2,
/obj/effect/turf_decal/trimline/white/warning{
	dir = 1
	},
/obj/machinery/light/small/dim/directional/south,
/turf/open/floor/iron,
/area/station/maintenance/tram/mid)
"l" = (
/obj/effect/turf_decal/trimline/neutral/filled/line{
	dir = 1
	},
/obj/effect/decal/cleanable/dirt,
/obj/effect/turf_decal/siding/thinplating,
/obj/structure/disposalpipe/segment{
	dir = 6
	},
/obj/machinery/atmospherics/pipe/smart/manifold4w/supply/hidden/layer4,
/obj/machinery/atmospherics/pipe/smart/manifold4w/scrubbers/hidden/layer2,
/obj/structure/cable,
/obj/effect/turf_decal/trimline/white/warning,
/obj/machinery/power/apc/auto_name/directional/north,
/obj/structure/railing{
	dir = 8
	},
/turf/open/floor/iron,
/area/station/maintenance/tram/mid)
"m" = (
/obj/effect/turf_decal/trimline/neutral/filled/line{
	dir = 1
	},
/obj/effect/decal/cleanable/dirt,
/obj/effect/turf_decal/siding/thinplating,
/obj/machinery/atmospherics/pipe/smart/manifold4w/scrubbers/hidden/layer2,
/obj/machinery/atmospherics/pipe/smart/manifold4w/supply/hidden/layer4,
/obj/effect/turf_decal/trimline/white/warning,
/turf/open/floor/iron,
/area/station/maintenance/tram/mid)
"n" = (
/obj/effect/decal/cleanable/dirt,
/obj/effect/turf_decal/stripes/white/line{
	dir = 1
	},
/obj/effect/turf_decal/stripes/white/line,
/turf/open/floor/plating,
/area/station/maintenance/tram/mid)
"o" = (
/obj/effect/decal/cleanable/dirt,
/obj/effect/turf_decal/trimline/neutral/filled/line,
/obj/effect/turf_decal/siding/thinplating{
	dir = 1
	},
/obj/machinery/atmospherics/pipe/smart/manifold4w/supply/hidden/layer4,
/obj/machinery/atmospherics/pipe/smart/manifold4w/scrubbers/hidden/layer2,
/obj/effect/turf_decal/trimline/white/warning{
	dir = 1
	},
/turf/open/floor/iron,
/area/station/maintenance/tram/mid)
"q" = (
/obj/effect/decal/cleanable/dirt,
/obj/effect/turf_decal/stripes/white/line,
/obj/effect/turf_decal/stripes/white/line{
	dir = 1
	},
/turf/open/floor/plating,
/area/station/maintenance/tram/mid)
"r" = (
/obj/effect/decal/cleanable/dirt,
/obj/machinery/atmospherics/pipe/smart/manifold4w/supply/hidden/layer4,
/obj/machinery/atmospherics/pipe/smart/manifold4w/scrubbers/hidden/layer2,
/obj/effect/decal/cleanable/blood/tracks,
/obj/structure/stairs/north,
/turf/open/floor/iron,
/area/station/maintenance/tram/mid)
"s" = (
/obj/effect/decal/cleanable/dirt,
/obj/effect/turf_decal/stripes/white/line{
	dir = 1
	},
/obj/effect/turf_decal/stripes/white/line,
/obj/effect/landmark/event_spawn,
/obj/effect/decal/cleanable/blood/tracks{
	dir = 4
	},
/turf/open/floor/plating,
/area/station/maintenance/tram/mid)
"t" = (
/obj/effect/decal/cleanable/dirt,
/obj/effect/turf_decal/trimline/neutral/filled/corner,
/obj/effect/turf_decal/trimline/neutral/filled/corner{
	dir = 8
	},
/obj/effect/turf_decal/siding/thinplating{
	dir = 1
	},
/obj/structure/disposalpipe/segment{
	dir = 10
	},
/obj/machinery/atmospherics/pipe/smart/manifold4w/supply/hidden/layer4,
/obj/machinery/atmospherics/pipe/smart/manifold4w/scrubbers/hidden/layer2,
/obj/structure/cable,
/obj/effect/turf_decal/trimline/white/warning{
	dir = 1
	},
/turf/open/floor/iron,
/area/station/maintenance/tram/mid)
"u" = (
/obj/effect/decal/cleanable/dirt,
/obj/structure/lattice/catwalk,
/obj/machinery/atmospherics/pipe/smart/manifold4w/scrubbers/hidden/layer2,
/obj/machinery/atmospherics/pipe/smart/manifold4w/supply/hidden/layer4,
/turf/open/floor/plating,
/area/station/maintenance/tram/mid)
"w" = (
/obj/effect/turf_decal/trimline/neutral/filled/line{
	dir = 1
	},
/obj/effect/decal/cleanable/dirt,
/obj/effect/turf_decal/siding/thinplating,
/obj/structure/disposalpipe/segment{
	dir = 4
	},
/obj/machinery/atmospherics/pipe/smart/manifold4w/supply/hidden/layer4,
/obj/machinery/atmospherics/pipe/smart/manifold4w/scrubbers/hidden/layer2,
/obj/structure/cable,
/obj/effect/turf_decal/trimline/white/warning,
/turf/open/floor/iron,
/area/station/maintenance/tram/mid)
"x" = (
/obj/machinery/door/airlock/maintenance_hatch{
	name = "Tunnel Access Hatch"
	},
/obj/effect/mapping_helpers/airlock/access/all/engineering/maintenance,
/obj/effect/mapping_helpers/airlock/unres,
/obj/structure/disposalpipe/segment,
/obj/machinery/atmospherics/pipe/smart/manifold4w/supply/hidden/layer4,
/obj/machinery/atmospherics/pipe/smart/manifold4w/scrubbers/hidden/layer2,
/obj/structure/cable,
/turf/open/floor/catwalk_floor,
/area/station/maintenance/central/lesser)
"y" = (
/obj/effect/decal/cleanable/dirt,
/obj/effect/turf_decal/siding/thinplating,
/obj/machinery/atmospherics/pipe/smart/manifold4w/supply/hidden/layer4,
/obj/machinery/atmospherics/pipe/smart/manifold4w/scrubbers/hidden/layer2,
/obj/effect/turf_decal/trimline/white/warning,
/obj/structure/railing{
	dir = 4
	},
/turf/open/floor/iron,
/area/station/maintenance/tram/mid)
"z" = (
/obj/effect/decal/cleanable/dirt,
/obj/effect/decal/cleanable/blood/tracks,
/turf/open/floor/iron/white,
/area/station/maintenance/tram/mid)
"B" = (
/obj/effect/turf_decal/trimline/neutral/filled/line{
	dir = 1
	},
/obj/effect/decal/cleanable/dirt,
/obj/effect/turf_decal/siding/thinplating,
/obj/machinery/atmospherics/pipe/smart/manifold4w/supply/hidden/layer4,
/obj/machinery/atmospherics/pipe/smart/manifold4w/scrubbers/hidden/layer2,
/obj/effect/turf_decal/trimline/white/warning,
/obj/machinery/vending/cigarette{
	pixel_x = -5
	},
/obj/structure/railing{
	dir = 4
	},
/turf/open/floor/iron,
/area/station/maintenance/tram/mid)
"C" = (
/obj/effect/decal/cleanable/dirt,
/obj/structure/lattice/catwalk,
/turf/open/floor/plating,
/area/station/maintenance/tram/mid)
"D" = (
/obj/effect/turf_decal/trimline/neutral/filled/line,
/obj/effect/decal/cleanable/dirt,
/turf/open/floor/iron,
/area/station/maintenance/tram/mid)
"E" = (
/obj/effect/decal/cleanable/dirt,
/obj/effect/turf_decal/stripes/white/line{
	dir = 1
	},
/obj/effect/turf_decal/stripes/white/line,
/obj/effect/decal/cleanable/blood/tracks{
	dir = 4
	},
/turf/open/floor/plating,
/area/station/maintenance/tram/mid)
"F" = (
/turf/closed/wall/r_wall,
/area/station/maintenance/central/lesser)
"G" = (
/obj/effect/turf_decal/trimline/neutral/filled/corner{
	dir = 4
	},
/obj/effect/turf_decal/trimline/neutral/filled/corner{
	dir = 1
	},
/obj/effect/decal/cleanable/dirt,
/obj/effect/turf_decal/bot_red,
/obj/effect/turf_decal/siding/thinplating,
/obj/structure/disposalpipe/segment{
	dir = 9
	},
/obj/machinery/atmospherics/pipe/smart/manifold4w/scrubbers/hidden/layer2,
/obj/machinery/atmospherics/pipe/smart/manifold4w/supply/hidden/layer4,
/obj/structure/cable,
/obj/effect/turf_decal/trimline/white/warning,
/turf/open/floor/iron,
/area/station/maintenance/tram/mid)
"H" = (
/turf/closed/wall,
/area/station/maintenance/tram/mid)
"I" = (
/obj/effect/decal/cleanable/dirt,
/obj/machinery/atmospherics/pipe/smart/manifold4w/supply/hidden/layer4,
/obj/machinery/atmospherics/pipe/smart/manifold4w/scrubbers/hidden/layer2,
/obj/structure/stairs/north,
/turf/open/floor/iron,
/area/station/maintenance/tram/mid)
"J" = (
/obj/effect/decal/cleanable/dirt,
/obj/effect/turf_decal/siding/thinplating{
	dir = 1
	},
/obj/machinery/atmospherics/pipe/smart/manifold4w/scrubbers/hidden/layer2,
/obj/machinery/atmospherics/pipe/smart/manifold4w/supply/hidden/layer4,
/obj/effect/turf_decal/trimline/white/warning{
	dir = 1
	},
/obj/structure/railing{
	dir = 4
	},
/turf/open/floor/iron,
/area/station/maintenance/tram/mid)
"K" = (
/obj/effect/turf_decal/trimline/neutral/filled/line{
	dir = 1
	},
/obj/effect/decal/cleanable/dirt,
/obj/effect/turf_decal/siding/thinplating,
/obj/machinery/atmospherics/pipe/smart/manifold4w/scrubbers/hidden/layer2,
/obj/machinery/atmospherics/pipe/smart/manifold4w/supply/hidden/layer4,
/obj/effect/turf_decal/trimline/white/warning,
/obj/machinery/light/small/dim/directional/north,
/turf/open/floor/iron,
/area/station/maintenance/tram/mid)
"L" = (
/obj/effect/decal/cleanable/dirt,
/obj/structure/lattice/catwalk,
/obj/structure/disposalpipe/segment,
/obj/structure/cable,
/turf/open/floor/plating,
/area/station/maintenance/tram/mid)
"M" = (
/obj/effect/decal/cleanable/dirt,
/turf/open/floor/iron/white,
/area/station/maintenance/tram/mid)
"N" = (
/turf/closed/wall,
/area/station/maintenance/central/lesser)
"O" = (
/obj/effect/decal/cleanable/dirt,
/obj/effect/turf_decal/siding/thinplating{
	dir = 1
	},
/obj/machinery/atmospherics/pipe/smart/manifold4w/supply/hidden/layer4,
/obj/machinery/atmospherics/pipe/smart/manifold4w/scrubbers/hidden/layer2,
/obj/effect/turf_decal/trimline/white/warning{
	dir = 1
	},
/obj/structure/railing{
	dir = 8
	},
/turf/open/floor/iron,
/area/station/maintenance/tram/mid)
"P" = (
/obj/effect/decal/cleanable/dirt,
/obj/effect/turf_decal/stripes/white/line{
	dir = 1
	},
/obj/effect/turf_decal/stripes/white/line,
/obj/structure/lattice/catwalk,
/obj/effect/decal/cleanable/blood/tracks{
	dir = 4
	},
/turf/open/floor/plating,
/area/station/maintenance/tram/mid)
"Q" = (
/obj/effect/turf_decal/trimline/neutral/filled/line,
/obj/effect/decal/cleanable/dirt,
/obj/effect/turf_decal/siding/thinplating{
	dir = 1
	},
/obj/machinery/atmospherics/pipe/smart/manifold4w/supply/hidden/layer4,
/obj/machinery/atmospherics/pipe/smart/manifold4w/scrubbers/hidden/layer2,
/obj/effect/turf_decal/trimline/white/warning{
	dir = 1
	},
/obj/machinery/airalarm/directional/south,
/obj/structure/railing{
	dir = 4
	},
/turf/open/floor/iron,
/area/station/maintenance/tram/mid)
"R" = (
/obj/effect/turf_decal/trimline/neutral/filled/line,
/obj/effect/decal/cleanable/dirt,
/obj/machinery/atmospherics/components/unary/vent_scrubber/on/layer2{
	dir = 1
	},
/turf/open/floor/iron,
/area/station/maintenance/tram/mid)
"S" = (
/obj/effect/decal/cleanable/dirt,
/obj/effect/turf_decal/stripes/white/line{
	dir = 1
	},
/obj/effect/turf_decal/stripes/white/line,
/obj/structure/lattice/catwalk,
/obj/structure/disposalpipe/segment,
/obj/structure/cable,
/turf/open/floor/plating,
/area/station/maintenance/tram/mid)
"T" = (
/turf/closed/wall/r_wall,
/area/station/maintenance/tram/mid)
"U" = (
/obj/effect/decal/cleanable/dirt,
/obj/effect/turf_decal/stripes/white/line{
	dir = 1
	},
/obj/effect/turf_decal/stripes/white/line,
/turf/open/floor/iron/white,
/area/station/maintenance/tram/mid)
"V" = (
/obj/effect/decal/cleanable/dirt,
/obj/machinery/atmospherics/pipe/smart/manifold4w/scrubbers/hidden/layer2,
/obj/machinery/atmospherics/pipe/smart/manifold4w/supply/hidden/layer4,
/obj/structure/stairs/south,
/turf/open/floor/iron,
/area/station/maintenance/tram/mid)
"X" = (
/obj/effect/decal/cleanable/dirt,
/obj/effect/turf_decal/trimline/neutral/filled/line,
/obj/machinery/camera/directional/south{
	c_tag = "Maintenance - Central Tram Tunnel 2"
	},
/obj/effect/turf_decal/siding/thinplating{
	dir = 1
	},
/obj/structure/disposalpipe/segment{
	dir = 5
	},
/obj/machinery/atmospherics/pipe/smart/manifold4w/scrubbers/hidden/layer2,
/obj/machinery/atmospherics/pipe/smart/manifold4w/supply/hidden/layer4,
/obj/structure/cable,
/obj/effect/turf_decal/trimline/white/warning{
	dir = 1
	},
/obj/machinery/light/small/dim/directional/south,
/obj/machinery/vending/coffee{
	pixel_x = 5
	},
/obj/structure/railing{
	dir = 8
	},
/turf/open/floor/iron,
/area/station/maintenance/tram/mid)
"Y" = (
/obj/effect/turf_decal/trimline/neutral/filled/line{
	dir = 1
	},
/obj/effect/decal/cleanable/dirt,
/obj/structure/bed/dogbed{
	name = "cat bed";
	desc = "A comfy-looking cat bed. You can even strap your pet in, in case the gravity turns off."
	},
/mob/living/basic/pet/cat/jerry,
/obj/machinery/atmospherics/components/unary/vent_pump/on/layer4,
/turf/open/floor/iron,
/area/station/maintenance/tram/mid)
"Z" = (
/obj/effect/turf_decal/siding/thinplating/dark{
	dir = 10
	},
/obj/effect/decal/cleanable/dirt,
/turf/open/floor/iron/dark,
/area/station/maintenance/tram/mid)

(1,1,1) = {"
Z
y
i
a
n
a
u
J
R
"}
(2,1,1) = {"
H
r
b
M
U
M
M
V
H
"}
(3,1,1) = {"
H
l
L
L
S
L
L
X
N
"}
(4,1,1) = {"
H
w
a
a
E
a
a
t
x
"}
(5,1,1) = {"
H
w
a
a
E
a
a
k
F
"}
(6,1,1) = {"
H
w
a
a
E
a
a
o
T
"}
(7,1,1) = {"
H
j
a
a
E
a
a
d
T
"}
(8,1,1) = {"
h
G
a
a
s
a
a
g
T
"}
(9,1,1) = {"
H
K
a
a
E
a
a
o
T
"}
(10,1,1) = {"
H
m
a
a
E
a
a
o
T
"}
(11,1,1) = {"
H
m
a
a
E
a
a
o
T
"}
(12,1,1) = {"
H
m
a
a
E
a
a
o
H
"}
(13,1,1) = {"
H
B
C
C
P
C
C
Q
H
"}
(14,1,1) = {"
H
I
M
M
e
z
z
f
H
"}
(15,1,1) = {"
Y
c
i
a
q
a
i
O
D
"}
