//MAP CONVERTED BY dmm2tgm.py THIS HEADER COMMENT PREVENTS RECONVERSION, DO NOT REMOVE
"a" = (
/obj/structure/table/reinforced/rglass,
/obj/item/storage/medkit/regular{
	pixel_x = -4;
	pixel_y = 13
	},
/obj/item/storage/box/bandages{
	pixel_x = -8;
	pixel_y = 0
	},
/obj/item/reagent_containers/spray/cleaner{
	pixel_x = 8;
	pixel_y = 7
	},
/obj/machinery/firealarm/directional/west,
/obj/effect/turf_decal/trimline/blue/filled/line{
	dir = 8
	},
/turf/open/floor/iron/white,
/area/station/security/medical)
"c" = (
/obj/effect/turf_decal/tile/blue{
	dir = 8
	},
/turf/open/floor/iron/white,
/area/station/security/medical)
"e" = (
/turf/template_noop,
/area/template_noop)
"f" = (
/obj/effect/turf_decal/tile/blue,
/obj/effect/turf_decal/tile/blue{
	dir = 4
	},
/obj/effect/turf_decal/tile/blue{
	dir = 8
	},
/turf/open/floor/iron/white,
/area/station/security/medical)
"h" = (
/obj/structure/window/reinforced/spawner/directional/north,
/obj/structure/table/reinforced,
/obj/item/paper_bin{
	pixel_x = 6;
	pixel_y = 2
	},
/obj/item/pen{
	pixel_x = 6;
	pixel_y = 4
	},
/obj/item/folder/white{
	pixel_x = 2;
	pixel_y = -12
	},
/obj/item/folder/red{
	pixel_x = -3;
	pixel_y = -12
	},
/obj/item/reagent_containers/cup/glass/mug/nanotrasen{
	pixel_x = -8;
	pixel_y = 3
	},
/obj/machinery/atmospherics/components/unary/vent_scrubber/on/layer2{
	dir = 8
	},
/obj/effect/turf_decal/trimline/blue/filled/line{
	dir = 5
	},
/turf/open/floor/iron/white,
/area/station/security/medical)
"i" = (
/obj/structure/cable,
/obj/machinery/atmospherics/pipe/smart/manifold4w/scrubbers/hidden/layer2,
/obj/machinery/atmospherics/pipe/smart/manifold4w/supply/hidden/layer4,
/turf/open/floor/iron/white,
/area/station/security/medical)
"l" = (
/obj/structure/table/optable,
/obj/machinery/defibrillator_mount/directional/north,
/obj/machinery/light/cold/directional/north,
/obj/effect/turf_decal/trimline/blue/filled/line{
	dir = 1
	},
/turf/open/floor/iron/white,
/area/station/security/medical)
"o" = (
/obj/effect/turf_decal/trimline/blue/filled/corner,
/obj/effect/turf_decal/trimline/blue/filled/corner{
	dir = 8
	},
/turf/open/floor/iron/white,
/area/station/security/medical)
"p" = (
/turf/closed/wall,
/area/station/security/medical)
"q" = (
/obj/machinery/atmospherics/pipe/smart/manifold4w/supply/hidden/layer4,
/obj/machinery/atmospherics/pipe/smart/manifold4w/scrubbers/hidden/layer2,
/obj/structure/sink/directional/north,
/obj/effect/turf_decal/trimline/blue/filled/line,
/turf/open/floor/iron/white,
/area/station/security/medical)
"r" = (
/obj/machinery/firealarm/directional/south,
/obj/effect/turf_decal/trimline/blue/filled/end,
/obj/structure/filingcabinet/chestdrawer,
/turf/open/floor/iron/white,
/area/station/security/medical)
"s" = (
/obj/effect/turf_decal/tile/blue{
	dir = 4
	},
/obj/structure/chair/office/light{
	dir = 8
	},
/obj/effect/landmark/start/security_medic,
/turf/open/floor/iron/white,
/area/station/security/medical)
"v" = (
/turf/closed/wall/r_wall,
/area/station/maintenance/department/eva)
"w" = (
/obj/effect/turf_decal/trimline/blue/filled/corner,
/obj/effect/turf_decal/trimline/blue/filled/line{
	dir = 8
	},
/turf/open/floor/iron/white,
/area/station/security/medical)
"x" = (
/obj/machinery/computer/operating{
	dir = 4
	},
/obj/item/radio/intercom/directional/west,
/obj/effect/turf_decal/trimline/blue/filled/line{
	dir = 9
	},
/obj/machinery/vitals_reader/directional/north,
/turf/open/floor/iron/white,
/area/station/security/medical)
"z" = (
/obj/effect/turf_decal/tile/neutral/half/contrasted{
	dir = 1
	},
/obj/effect/turf_decal/trimline/red/real_red/end{
	dir = 4;
	alpha = 160
	},
/obj/structure/bodycontainer/morgue{
	dir = 8
	},
/obj/structure/window/reinforced/spawner/directional/north,
/obj/effect/turf_decal/siding/dark/end{
	dir = 4
	},
/turf/open/floor/iron/dark,
/area/station/security/medical)
"A" = (
/obj/machinery/atmospherics/pipe/smart/manifold4w/scrubbers/hidden/layer2,
/obj/effect/turf_decal/trimline/blue/filled/line,
/obj/structure/chair/office{
	dir = 4
	},
/obj/effect/landmark/start/security_medic,
/obj/machinery/atmospherics/pipe/smart/manifold4w/supply/hidden/layer4,
/turf/open/floor/iron/white,
/area/station/security/medical)
"B" = (
/obj/structure/cable,
/obj/effect/turf_decal/trimline/blue/filled/corner{
	dir = 4
	},
/turf/open/floor/iron/white,
/area/station/security/medical)
"D" = (
/obj/structure/window/reinforced/spawner/directional/east,
/obj/structure/sign/departments/medbay/alt{
	pixel_y = -32
	},
/obj/machinery/atmospherics/components/unary/vent_scrubber/on/layer2{
	dir = 1
	},
/obj/effect/turf_decal/trimline/blue/filled/line{
	dir = 6
	},
/obj/machinery/medipen_refiller,
/turf/open/floor/iron/white,
/area/station/security/medical)
"E" = (
/obj/structure/window/reinforced/spawner/directional/east,
/obj/structure/sign/departments/medbay/alt{
	pixel_y = 32
	},
/obj/effect/turf_decal/trimline/blue/filled/line{
	dir = 5
	},
/obj/structure/closet/secure_closet/security_medic,
/turf/open/floor/iron/white,
/area/station/security/medical)
"F" = (
/obj/machinery/atmospherics/pipe/smart/manifold4w/supply/hidden/layer4,
/obj/machinery/atmospherics/pipe/smart/manifold4w/scrubbers/hidden/layer2,
/obj/machinery/door/airlock/maintenance_hatch{
	name = "Security Maintenance Hatch"
	},
/obj/effect/mapping_helpers/airlock/access/all/security/general,
/turf/open/floor/catwalk_floor,
/area/station/security/medical)
"G" = (
/obj/structure/table/reinforced/rglass,
/obj/item/reagent_containers/cup/bottle/epinephrine{
	pixel_x = -7;
	pixel_y = 12
	},
/obj/item/reagent_containers/cup/bottle/multiver{
	pixel_x = -3;
	pixel_y = 12
	},
/obj/item/reagent_containers/syringe{
	pixel_x = -5;
	pixel_y = 0
	},
/obj/item/reagent_containers/cup/bottle/formaldehyde{
	pixel_x = 1;
	pixel_y = 12
	},
/obj/structure/sign/poster/official/moth_epi/directional/west,
/obj/effect/turf_decal/trimline/blue/filled/line{
	dir = 8
	},
/obj/machinery/camera{
	dir = 10;
	network = list("ss13","Security");
	c_tag = "Security - Medical Center"
	},
/turf/open/floor/iron/white,
/area/station/security/medical)
"I" = (
/obj/machinery/power/apc/auto_name/directional/north,
/obj/structure/cable,
/obj/machinery/stasis,
/obj/item/bedsheet/medical,
/obj/machinery/iv_drip,
/obj/effect/turf_decal/trimline/blue/filled/line{
	dir = 5
	},
/turf/open/floor/iron/white,
/area/station/security/medical)
"J" = (
/obj/effect/landmark/event_spawn,
/obj/machinery/atmospherics/pipe/smart/manifold4w/scrubbers/hidden/layer2,
/obj/machinery/atmospherics/pipe/smart/manifold4w/supply/hidden/layer4,
/turf/open/floor/iron/white,
/area/station/security/medical)
"K" = (
/obj/machinery/computer/records/medical/laptop{
	dir = 8;
	pixel_y = 3;
	pixel_x = -5
	},
/obj/structure/table/reinforced,
/obj/machinery/atmospherics/components/unary/vent_pump/on/layer4{
	dir = 8
	},
/obj/machinery/light/cold/directional/east,
/obj/structure/noticeboard/directional/east,
/obj/effect/turf_decal/trimline/blue/filled/line{
	dir = 6
	},
/turf/open/floor/iron/white,
/area/station/security/medical)
"L" = (
/turf/closed/wall/r_wall,
/area/station/security/medical)
"M" = (
/obj/machinery/airalarm/directional/south,
/obj/structure/table/reinforced/rglass,
/obj/structure/extinguisher_cabinet/directional/west,
/obj/effect/turf_decal/trimline/blue/filled/line{
	dir = 10
	},
/obj/item/reagent_containers/blood/o_minus{
	pixel_x = -6;
	pixel_y = 10
	},
/obj/item/reagent_containers/blood/o_minus{
	pixel_x = -3;
	pixel_y = 7
	},
/obj/item/reagent_containers/blood/lizard{
	pixel_x = 1;
	pixel_y = 4
	},
/obj/item/paper/fluff/jobs/medical/blood_types{
	pixel_x = 6;
	pixel_y = 13
	},
/turf/open/floor/iron/white,
/area/station/security/medical)
"N" = (
/obj/effect/turf_decal/tile/neutral/fourcorners,
/obj/effect/turf_decal/trimline/red/real_red/end{
	dir = 8;
	alpha = 160
	},
/obj/machinery/light/cold/directional/south,
/obj/structure/window/reinforced/spawner/directional/west{
	pixel_x = -3;
	pixel_y = 0
	},
/obj/structure/sign/poster/official/cleanliness/directional/south,
/obj/effect/turf_decal/siding/dark/end{
	dir = 8
	},
/turf/open/floor/iron/dark,
/area/station/security/medical)
"T" = (
/obj/structure/cable,
/obj/machinery/atmospherics/pipe/smart/manifold4w/scrubbers/hidden/layer2,
/obj/machinery/atmospherics/pipe/smart/manifold4w/supply/hidden/layer4,
/obj/machinery/door/window/right/directional/east{
	name = "Brig Infirmary"
	},
/obj/machinery/door/firedoor/border_only{
	dir = 4;
	pixel_x = 1;
	pixel_y = 0
	},
/obj/effect/turf_decal/trimline/blue/filled/warning{
	dir = 4
	},
/turf/open/floor/iron/white,
/area/station/security/medical)
"U" = (
/obj/structure/window/reinforced/spawner/directional/north,
/obj/machinery/computer/crew,
/obj/structure/table/reinforced,
/obj/machinery/atmospherics/pipe/smart/manifold4w/supply/hidden/layer4,
/obj/machinery/atmospherics/pipe/smart/manifold4w/scrubbers/hidden/layer2,
/obj/effect/turf_decal/trimline/blue/filled/line{
	dir = 1
	},
/turf/open/floor/iron/white,
/area/station/security/medical)
"V" = (
/obj/machinery/atmospherics/components/unary/vent_pump/on/layer4{
	dir = 1
	},
/obj/effect/turf_decal/trimline/blue/filled/line,
/obj/structure/closet/crate/freezer/surplus_limbs,
/turf/open/floor/iron/white,
/area/station/security/medical)
"W" = (
/obj/machinery/door/window/brigdoor/right/directional/south{
	req_access = list("security");
	name = "Security Infirmary";
	dir = 1
	},
/obj/machinery/door/firedoor/border_only{
	dir = 1;
	pixel_x = 0;
	pixel_y = 1
	},
/obj/effect/turf_decal/trimline/blue/filled/corner{
	dir = 4
	},
/obj/effect/turf_decal/trimline/blue/filled/warning{
	dir = 1;
	pixel_x = 0;
	pixel_y = 1
	},
/obj/effect/turf_decal/trimline/blue/filled/line{
	dir = 8
	},
/turf/open/floor/iron/white,
/area/station/security/medical)
"X" = (
/obj/structure/table/reinforced/rglass,
/obj/effect/spawner/surgery_tray/full,
/obj/machinery/wall_healer/directional/north,
/obj/effect/turf_decal/trimline/blue/filled/line{
	dir = 1
	},
/turf/open/floor/iron/white,
/area/station/security/medical)

(1,1,1) = {"
L
L
L
L
L
L
e
e
e
"}
(2,1,1) = {"
p
x
G
a
M
L
F
L
v
"}
(3,1,1) = {"
p
l
f
s
o
W
w
r
v
"}
(4,1,1) = {"
p
X
c
J
q
U
A
N
v
"}
(5,1,1) = {"
p
I
B
i
V
h
K
z
v
"}
(6,1,1) = {"
p
p
E
T
D
v
v
v
v
"}
