//MAP CONVERTED BY dmm2tgm.py THIS HEADER COMMENT PREVENTS RECONVERSION, DO NOT REMOVE
"at" = (
/obj/effect/turf_decal/trimline/blue/filled/line{
	dir = 1
	},
/obj/effect/turf_decal/trimline/blue/filled/corner{
	dir = 8
	},
/obj/machinery/atmospherics/pipe/smart/manifold4w/scrubbers/hidden/layer2,
/obj/machinery/firealarm/directional/north,
/turf/open/floor/iron/white,
/area/station/security/prison)
"aL" = (
/obj/effect/turf_decal/trimline/blue/filled/end{
	dir = 8
	},
/turf/open/floor/iron/white,
/area/station/security/prison)
"bb" = (
/obj/structure/window/reinforced/spawner/directional/east,
/obj/effect/turf_decal/stripes/white/line{
	dir = 4
	},
/obj/structure/closet,
/obj/effect/spawner/random/medical/medkit,
/obj/structure/sign/poster/official/plasma_effects/directional/south,
/turf/open/floor/iron/dark,
/area/station/security/prison)
"dh" = (
/obj/machinery/door/firedoor,
/obj/machinery/door/airlock/security/glass{
	name = "Prison Sanitarium"
	},
/obj/machinery/atmospherics/pipe/smart/manifold4w/supply/hidden/layer4,
/obj/machinery/atmospherics/pipe/smart/manifold4w/scrubbers/hidden/layer2,
/obj/effect/mapping_helpers/airlock/access/all/security/brig,
/turf/open/floor/iron/white/side,
/area/station/security/prison)
"hj" = (
/obj/effect/turf_decal/trimline/blue/filled/line,
/obj/effect/turf_decal/trimline/blue/filled/line{
	dir = 1
	},
/obj/machinery/atmospherics/pipe/smart/manifold4w/scrubbers/hidden/layer2,
/turf/open/floor/iron/white,
/area/station/security/prison)
"hZ" = (
/obj/effect/spawner/structure/window/reinforced,
/obj/structure/cable,
/turf/open/floor/plating,
/area/station/security/prison)
"iE" = (
/obj/structure/table/optable,
/obj/item/storage/medkit/surgery,
/turf/open/floor/iron/dark,
/area/station/security/prison)
"mF" = (
/obj/effect/turf_decal/stripes/white/line{
	dir = 1
	},
/obj/machinery/atmospherics/components/unary/vent_scrubber/on/layer2{
	dir = 1
	},
/turf/open/floor/iron/dark,
/area/station/security/prison)
"vT" = (
/obj/structure/bed/medical/anchored{
	dir = 1
	},
/obj/item/bedsheet/medical,
/obj/effect/turf_decal/trimline/blue/filled/line{
	dir = 6
	},
/turf/open/floor/iron/white,
/area/station/security/prison)
"yb" = (
/obj/effect/turf_decal/trimline/blue/filled/line{
	dir = 10
	},
/obj/item/storage/box/bandages{
	pixel_x = 6
	},
/obj/item/stack/medical/mesh{
	pixel_x = -6
	},
/obj/item/healthanalyzer/simple{
	pixel_y = 8
	},
/obj/structure/table,
/obj/item/storage/medkit,
/turf/open/floor/iron/white,
/area/station/security/prison)
"Dt" = (
/obj/machinery/light/directional/south,
/obj/machinery/wall_healer/free/directional/south,
/obj/machinery/camera/directional/south,
/turf/open/floor/iron/dark,
/area/station/security/prison)
"Du" = (
/obj/structure/bed/medical/anchored{
	dir = 1
	},
/obj/item/bedsheet/medical,
/obj/effect/turf_decal/trimline/blue/filled/line{
	dir = 4
	},
/obj/structure/window/reinforced/spawner/directional/north{
	pixel_y = 1
	},
/obj/structure/sign/poster/official/obey/directional/east,
/turf/open/floor/iron/white,
/area/station/security/prison)
"Ge" = (
/obj/structure/window/reinforced/spawner/directional/east,
/obj/effect/turf_decal/stripes/white/line{
	dir = 10
	},
/obj/structure/closet,
/obj/effect/spawner/random/medical/medkit,
/turf/open/floor/iron/dark,
/area/station/security/prison)
"Li" = (
/obj/effect/turf_decal/stripes/white/line{
	dir = 1
	},
/obj/machinery/computer/operating{
	dir = 4
	},
/obj/structure/sign/poster/official/moth_meth/directional/west,
/turf/open/floor/iron/dark,
/area/station/security/prison)
"Pt" = (
/obj/effect/turf_decal/trimline/blue/filled/line{
	dir = 5
	},
/obj/machinery/atmospherics/pipe/smart/manifold4w/scrubbers/hidden/layer2,
/obj/machinery/atmospherics/pipe/smart/manifold4w/supply/hidden/layer4,
/turf/open/floor/iron/white,
/area/station/security/prison)
"PR" = (
/turf/closed/wall/r_wall,
/area/station/security/prison)
"Ri" = (
/obj/effect/turf_decal/trimline/blue/filled/line{
	dir = 8
	},
/turf/open/floor/iron/white,
/area/station/security/prison)
"RV" = (
/obj/effect/turf_decal/trimline/blue/filled/line{
	dir = 1
	},
/obj/machinery/atmospherics/pipe/smart/manifold4w/scrubbers/hidden/layer2,
/obj/machinery/atmospherics/pipe/smart/manifold4w/supply/hidden/layer4,
/obj/structure/sign/poster/official/nanotrasen_logo/directional/north,
/turf/open/floor/iron/white,
/area/station/security/prison)
"Tl" = (
/obj/machinery/door/airlock/security/glass{
	name = "Prison Sanitarium"
	},
/obj/machinery/door/firedoor,
/obj/effect/turf_decal/trimline/blue/filled/warning{
	dir = 4
	},
/obj/machinery/atmospherics/pipe/smart/manifold4w/scrubbers/hidden/layer2,
/obj/machinery/atmospherics/pipe/smart/manifold4w/supply/hidden/layer4,
/obj/effect/mapping_helpers/airlock/access/all/security/brig,
/turf/open/floor/iron/dark,
/area/station/security/prison)
"Vo" = (
/obj/effect/turf_decal/trimline/blue/filled/line,
/obj/machinery/light/directional/south,
/obj/item/radio/intercom/directional/south,
/turf/open/floor/iron/white,
/area/station/security/prison)
"ZJ" = (
/obj/machinery/atmospherics/components/unary/vent_pump/on/layer4{
	dir = 1
	},
/turf/open/floor/iron/white,
/area/station/security/prison)

(1,1,1) = {"
PR
Tl
PR
PR
PR
"}
(2,1,1) = {"
hZ
aL
Li
iE
PR
"}
(3,1,1) = {"
hZ
hj
mF
Dt
PR
"}
(4,1,1) = {"
hZ
hj
Ge
bb
PR
"}
(5,1,1) = {"
PR
at
Ri
yb
PR
"}
(6,1,1) = {"
PR
RV
ZJ
Vo
PR
"}
(7,1,1) = {"
dh
Pt
Du
vT
PR
"}
(8,1,1) = {"
PR
PR
PR
PR
PR
"}
