//MAP CONVERTED BY dmm2tgm.py THIS HEADER COMMENT PREVENTS RECONVERSION, DO NOT REMOVE
"a" = (
/turf/template_noop,
/area/template_noop)
"b" = (
/obj/effect/decal/cleanable/dirt{
	icon_state = "dirt-flat-1"
	},
/turf/open/floor/plating,
/area/station/maintenance/port/fore)
"d" = (
/obj/effect/turf_decal/trimline/blue/filled/warning{
	dir = 4
	},
/obj/machinery/door/window/brigdoor/right/directional/south{
	req_access = list("security");
	name = "Security Infirmary";
	dir = 4
	},
/obj/machinery/atmospherics/pipe/smart/manifold4w/scrubbers/hidden/layer2,
/obj/machinery/atmospherics/pipe/smart/manifold4w/supply/hidden/layer4,
/turf/open/floor/iron/white,
/area/station/security/medical)
"e" = (
/obj/effect/turf_decal/trimline/blue/filled/line{
	dir = 4
	},
/obj/machinery/power/apc/auto_name/directional/east,
/obj/structure/cable,
/obj/structure/table/reinforced,
/obj/item/reagent_containers/cup/bottle/multiver{
	pixel_x = 8;
	pixel_y = 16
	},
/obj/item/reagent_containers/cup/bottle/epinephrine{
	pixel_x = 0;
	pixel_y = 16
	},
/obj/item/reagent_containers/syringe{
	pixel_x = -2;
	pixel_y = 4
	},
/obj/item/healthanalyzer{
	pixel_x = 3;
	pixel_y = -6
	},
/obj/item/reagent_containers/cup/bottle/formaldehyde{
	pixel_y = 16;
	pixel_x = -8
	},
/turf/open/floor/iron/white,
/area/station/security/medical)
"g" = (
/obj/effect/spawner/structure/window/reinforced,
/obj/structure/cable,
/turf/open/floor/plating,
/area/station/security/medical)
"h" = (
/obj/machinery/airalarm/directional/north,
/obj/effect/turf_decal/trimline/blue/filled/line{
	dir = 9
	},
/obj/machinery/camera/directional/north{
	c_tag = "Security - Medbay Waiting Room"
	},
/obj/structure/closet/secure_closet/security_medic,
/obj/machinery/atmospherics/components/unary/vent_pump/on/layer4,
/turf/open/floor/iron/white,
/area/station/security/medical)
"i" = (
/obj/effect/turf_decal/trimline/blue/filled/line{
	dir = 8
	},
/obj/machinery/atmospherics/components/unary/vent_scrubber/on/layer2{
	dir = 4
	},
/turf/open/floor/iron/white,
/area/station/security/medical)
"j" = (
/obj/effect/turf_decal/trimline/blue/filled/line{
	dir = 6
	},
/obj/structure/window/reinforced/spawner/directional/east,
/obj/structure/table/reinforced/rglass,
/obj/effect/spawner/surgery_tray/full,
/turf/open/floor/iron/white,
/area/station/security/medical)
"k" = (
/obj/effect/turf_decal/trimline/blue/filled/line{
	dir = 4
	},
/obj/structure/table/reinforced,
/obj/machinery/computer/records/medical/laptop{
	dir = 8;
	pixel_y = 3;
	pixel_x = -4
	},
/obj/structure/cable,
/turf/open/floor/iron/white,
/area/station/security/medical)
"m" = (
/obj/machinery/atmospherics/pipe/smart/manifold4w/scrubbers/hidden/layer2,
/obj/machinery/atmospherics/pipe/smart/manifold4w/supply/hidden/layer4,
/obj/effect/landmark/start/security_medic,
/turf/open/floor/iron/white,
/area/station/security/medical)
"n" = (
/obj/effect/turf_decal/trimline/blue/filled/warning,
/obj/structure/cable,
/obj/machinery/atmospherics/pipe/smart/manifold4w/supply/hidden/layer4,
/obj/machinery/atmospherics/pipe/smart/manifold4w/scrubbers/hidden/layer2,
/turf/open/floor/iron/white,
/area/station/security/medical)
"o" = (
/obj/effect/turf_decal/trimline/blue/filled/line{
	dir = 1
	},
/obj/structure/table/reinforced,
/obj/machinery/computer/crew,
/obj/machinery/status_display/ai/directional/north,
/obj/machinery/light/directional/north,
/turf/open/floor/iron/white,
/area/station/security/medical)
"q" = (
/obj/effect/turf_decal/trimline/blue/filled/line,
/obj/structure/table/optable,
/obj/machinery/vitals_reader/directional/south,
/turf/open/floor/iron/white,
/area/station/security/medical)
"r" = (
/obj/effect/turf_decal/trimline/blue/filled/line{
	dir = 5
	},
/obj/structure/table/reinforced,
/obj/item/paper_bin{
	pixel_x = 7;
	pixel_y = 8
	},
/obj/item/pen{
	pixel_x = 8;
	pixel_y = 10
	},
/obj/item/reagent_containers/cup/glass/mug/nanotrasen{
	pixel_x = -8;
	pixel_y = -10
	},
/obj/item/folder/white{
	pixel_x = 9;
	pixel_y = -8
	},
/obj/item/folder/red{
	pixel_x = 4;
	pixel_y = -8
	},
/obj/item/reagent_containers/spray/cleaner{
	pixel_x = -9;
	pixel_y = 16
	},
/obj/structure/sign/poster/official/moth_epi/directional/east,
/turf/open/floor/iron/white,
/area/station/security/medical)
"s" = (
/obj/machinery/light/small/directional/south,
/obj/machinery/door/window/brigdoor/right/directional/east{
	name = "Cargo Deliveries";
	req_access = list("security")
	},
/turf/open/floor/iron/dark,
/area/station/security/brig)
"t" = (
/turf/open/floor/plating,
/area/station/maintenance/port/fore)
"u" = (
/obj/effect/turf_decal/trimline/blue/filled/warning{
	dir = 8
	},
/obj/machinery/atmospherics/pipe/smart/manifold4w/scrubbers/hidden/layer2,
/obj/machinery/atmospherics/pipe/smart/manifold4w/supply/hidden/layer4,
/turf/open/floor/iron/white,
/area/station/security/medical)
"v" = (
/turf/closed/wall,
/area/station/maintenance/port/fore)
"w" = (
/obj/structure/plasticflaps/opaque,
/obj/effect/turf_decal/delivery,
/obj/machinery/navbeacon{
	codes_txt = "delivery;dir=4";
	location = "Security"
	},
/turf/open/floor/iron/dark,
/area/station/security/brig)
"z" = (
/obj/effect/turf_decal/trimline/blue/filled/line{
	dir = 8
	},
/obj/machinery/atmospherics/pipe/smart/manifold4w/scrubbers/hidden/layer2,
/obj/structure/sink/directional/east,
/obj/structure/sign/poster/official/cleanliness/directional/west,
/turf/open/floor/iron/white,
/area/station/security/medical)
"B" = (
/obj/effect/turf_decal/trimline/blue/filled/line{
	dir = 9
	},
/obj/machinery/atmospherics/components/unary/vent_scrubber/on/layer2,
/obj/item/radio/intercom/directional/west,
/turf/open/floor/iron/white,
/area/station/security/medical)
"C" = (
/turf/closed/wall/r_wall,
/area/station/security/mechbay)
"D" = (
/obj/structure/cable,
/obj/machinery/atmospherics/pipe/smart/manifold4w/supply/hidden/layer4,
/obj/machinery/atmospherics/pipe/smart/manifold4w/scrubbers/hidden/layer2,
/obj/machinery/holopad/secure,
/turf/open/floor/iron/white,
/area/station/security/medical)
"F" = (
/obj/effect/turf_decal/trimline/blue/filled/line{
	dir = 10
	},
/obj/machinery/computer/operating{
	dir = 1
	},
/obj/machinery/defibrillator_mount/directional/south,
/turf/open/floor/iron/white,
/area/station/security/medical)
"G" = (
/obj/machinery/atmospherics/pipe/smart/manifold4w/supply/hidden/layer4,
/obj/machinery/atmospherics/pipe/smart/manifold4w/scrubbers/hidden/layer2,
/obj/effect/landmark/start/security_medic,
/obj/structure/chair/office/light{
	dir = 4
	},
/turf/open/floor/iron/white,
/area/station/security/medical)
"H" = (
/obj/effect/spawner/random/maintenance,
/obj/structure/closet/crate,
/turf/open/floor/plating,
/area/station/maintenance/port/fore)
"I" = (
/obj/effect/decal/cleanable/dirt{
	icon_state = "dirt-flat-1"
	},
/obj/effect/mapping_helpers/broken_floor,
/turf/open/floor/plating,
/area/station/maintenance/port/fore)
"M" = (
/obj/effect/turf_decal/trimline/blue/filled/line{
	dir = 5
	},
/obj/structure/window/reinforced/spawner/directional/east,
/obj/structure/bodycontainer/morgue{
	dir = 8
	},
/turf/open/floor/iron/white,
/area/station/security/medical)
"N" = (
/obj/effect/turf_decal/trimline/blue/filled/line{
	dir = 10
	},
/obj/machinery/wall_healer/directional/west,
/obj/machinery/stasis{
	dir = 4
	},
/obj/item/bedsheet/medical{
	dir = 4
	},
/obj/machinery/iv_drip,
/turf/open/floor/iron/white,
/area/station/security/medical)
"O" = (
/obj/effect/turf_decal/trimline/blue/filled/line{
	dir = 1
	},
/obj/machinery/atmospherics/components/unary/vent_pump/on/layer4,
/obj/machinery/light/small/directional/north,
/turf/open/floor/iron/white,
/area/station/security/medical)
"Q" = (
/obj/effect/turf_decal/trimline/blue/filled/line{
	dir = 6
	},
/obj/structure/table/reinforced,
/obj/machinery/firealarm/directional/east{
	pixel_x = 26;
	pixel_y = -5
	},
/obj/item/storage/box/bandages{
	pixel_x = 6
	},
/obj/item/stack/medical/mesh{
	pixel_x = -6
	},
/obj/item/storage/medkit/regular{
	pixel_x = 4;
	pixel_y = 10
	},
/obj/machinery/light_switch/directional/east{
	pixel_y = 5
	},
/turf/open/floor/iron/white,
/area/station/security/medical)
"R" = (
/obj/machinery/door/airlock/medical/glass{
	id_tag = "MedbayFoyer";
	name = "Brig Infirmary"
	},
/obj/effect/turf_decal/delivery/blue,
/obj/structure/cable,
/obj/machinery/atmospherics/pipe/smart/manifold4w/supply/hidden/layer4,
/obj/machinery/atmospherics/pipe/smart/manifold4w/scrubbers/hidden/layer2,
/obj/machinery/door/firedoor,
/obj/effect/mapping_helpers/airlock/access/all/security/general,
/turf/open/floor/iron/dark,
/area/station/security/medical)
"U" = (
/turf/closed/wall/r_wall,
/area/station/security/medical)
"W" = (
/obj/effect/mapping_helpers/airlock/access/all/security/general,
/obj/machinery/door/airlock/maintenance_hatch{
	name = "Security Maintenance"
	},
/turf/open/floor/iron,
/area/station/maintenance/port/fore)

(1,1,1) = {"
v
U
U
U
U
U
a
"}
(2,1,1) = {"
t
W
B
z
F
U
a
"}
(3,1,1) = {"
v
U
O
m
q
U
a
"}
(4,1,1) = {"
H
U
M
d
j
U
C
"}
(5,1,1) = {"
b
U
h
u
i
N
g
"}
(6,1,1) = {"
I
U
o
G
D
n
R
"}
(7,1,1) = {"
w
U
r
k
e
Q
g
"}
(8,1,1) = {"
s
U
U
g
U
U
U
"}
